,Ngày,Thay đổi (+/-%),Số lệnh mua,Khối lượng đặt mua,KLTB 1 lệnh mua,Số lệnh đặt bán,Khối lượng đặt bán,KLTB 1 lệnh bán,Chênh lệch KL đặt mua - đặt bán
1,09/06/2022,13.3 (6.40 %),3600,14726800,4091,3712,11482500,3093,3244300
2,08/06/2022,12.45 (2.89 %),2545,7378000,2899,2223,8332400,3748,-954400
3,07/06/2022,12.05 (-2.03 %),3013,8081000,2682,1716,8145900,4747,-64900
4,06/06/2022,12.25 (-2.00 %),1775,4497300,2534,1611,5722700,3552,-1225400
5,03/06/2022,12.45 (-0.40 %),2696,7161300,2656,1820,7708500,4235,-547200
6,02/06/2022,12.45 (-0.40 %),1910,6755700,3537,2340,6989600,2987,-233900
7,01/06/2022,12.5 (-0.79 %),2485,5687200,2289,1564,5688100,3637,-900
8,31/05/2022,12.6 (-1.56 %),2881,8138800,2825,1793,7832500,4368,306300
9,30/05/2022,12.75 (0.39 %),2157,6813000,3159,2028,7211600,3556,-398600
10,27/05/2022,12.65 (-1.17 %),2434,7489300,3077,2160,7917500,3666,-428200
11,26/05/2022,12.75 (1.19 %),3102,10198800,3288,3303,11261000,3409,-1062200
12,25/05/2022,12.6 (5.00 %),2754,10394600,3774,3554,10079300,2836,315300
13,24/05/2022,12 (0.84 %),2473,8248200,3335,1949,8361400,4290,-113200
14,23/05/2022,11.9 (-1.65 %),2314,6292600,2719,2015,6813000,3381,-520400
15,20/05/2022,12.1 (2.54 %),2850,9433200,3310,2553,7779300,3047,1653900
16,19/05/2022,11.8 (0.00 %),3861,10667400,2763,2036,7729200,3796,2938200
17,18/05/2022,11.8 (1.72 %),2930,8604400,2937,2314,8283100,3580,321300
18,17/05/2022,11.55 (6.94 %),2581,10232500,3965,1675,5884600,3513,4347900
19,16/05/2022,10.8 (0.00 %),0,0,,0,0,,0
20,13/05/2022,10.75 (-6.93 %),3667,11754600,3206,2298,11392500,4958,362100
1,12/05/2022,11.55 (-6.85 %),2369,5406100,2282,1331,7316600,5497,-1910500
2,11/05/2022,12.4 (1.64 %),2097,6922500,3301,1626,5109500,3142,1813000
3,10/05/2022,12.2 (1.67 %),3305,10111800,3060,1756,6826500,3888,3285300
4,09/05/2022,12 (-6.98 %),3210,6967000,2170,1711,9615800,5620,-2648800
5,06/05/2022,12.85 (-4.10 %),3237,7532300,2327,1122,6597300,5880,935000
6,05/05/2022,13.4 (-2.90 %),2675,5588200,2089,1460,6633600,4544,-1045400
7,04/05/2022,13.8 (-2.13 %),2464,4803800,1950,1591,5837500,3669,-1033700
8,29/04/2022,14.05 (3.31 %),2758,9212000,3340,2586,8506400,3289,705600
9,28/04/2022,13.55 (0.37 %),2722,5689400,2090,2087,7197700,3449,-1508300
10,27/04/2022,13.5 (1.50 %),3438,8451200,2458,1581,6732300,4258,1718900
11,26/04/2022,13.3 (3.10 %),0,0,,0,0,,0
12,25/04/2022,12.85 (-6.88 %),3341,8367000,2504,2032,10511200,5173,-2144200
13,22/04/2022,13.8 (0.73 %),3715,9126100,2457,1964,7600100,3870,1526000
14,21/04/2022,13.7 (-4.20 %),4075,13611100,3340,2540,9962600,3922,3648500
15,20/04/2022,14.3 (-3.05 %),3435,10372700,3020,2307,8499100,3684,1873600
16,18/04/2022,15.85 (-6.21 %),4769,11532900,2418,2524,14279000,5657,-2746100
17,15/04/2022,16.9 (-1.74 %),2492,5300300,2127,1646,5619900,3414,-319600
18,14/04/2022,17.2 (-0.58 %),2188,4518800,2065,1850,5613200,3034,-1094400
19,13/04/2022,17.3 (3.59 %),3545,8627500,2434,1970,5526500,2805,3101000
20,12/04/2022,0 (0.00 %),3885,8379000,2157,1934,8976800,4642,-597800
1,08/04/2022,17.5 (0.00 %),4361,8750200,2006,2053,8727500,4251,22700
2,07/04/2022,17.5 (-4.89 %),6447,13859100,2150,3187,17196400,5396,-3337300
3,06/04/2022,18.35 (-1.87 %),4221,11940100,2829,3186,12803400,4019,-863300
4,05/04/2022,18.7 (-0.53 %),3188,9056700,2841,2921,13805800,4726,-4749100
5,04/04/2022,18.75 (-1.83 %),4004,10850000,2710,4110,16073300,3911,-5223300
6,01/04/2022,19.1 (2.14 %),3057,9149600,2993,3890,13185200,3390,-4035600
7,31/03/2022,18.7 (0.54 %),3327,9179200,2759,3821,14308200,3745,-5129000
8,30/03/2022,18.6 (-4.12 %),7088,15456000,2181,5469,19978800,3653,-4522800
9,29/03/2022,19.4 (2.11 %),5633,19500500,3462,8251,21795300,2642,-2294800
10,28/03/2022,19 (-0.52 %),5524,16482700,2984,6087,17359000,2852,-876300
11,25/03/2022,19.1 (-1.55 %),7391,19612200,2654,9586,24652000,2572,-5039800
12,24/03/2022,19.35 (6.91 %),11598,44983300,3879,10511,26309700,2503,18673600
13,23/03/2022,18.1 (1.69 %),5257,22359100,4253,6500,17417300,2680,4941800
14,22/03/2022,17.8 (0.00 %),3748,12802300,3416,3420,10060200,2942,2742100
15,21/03/2022,17.8 (1.14 %),3423,13099800,3827,3068,9286700,3027,3813100
16,18/03/2022,17.6 (-0.56 %),2546,6699600,2631,2770,8521400,3076,-1821800
17,17/03/2022,17.65 (-0.28 %),2285,6411200,2806,2990,8615700,2882,-2204500
18,16/03/2022,17.7 (1.72 %),2813,6870000,2442,3113,8245700,2649,-1375700
19,15/03/2022,17.35 (0.87 %),2635,5995100,2275,1711,5299900,3098,695200
20,14/03/2022,17.2 (-3.37 %),0,0,,0,0,,0
1,11/03/2022,17.8 (0.56 %),3804,12698700,3338,3474,10596400,3050,2102300
2,10/03/2022,17.7 (0.57 %),2821,7393100,2621,2348,7894300,3362,-501200
3,09/03/2022,17.55 (-0.85 %),5448,13005100,2387,2475,10090600,4077,2914500
4,08/03/2022,17.7 (-2.21 %),5127,11113900,2168,3924,12064200,3074,-950300
5,07/03/2022,18.05 (-1.90 %),6812,18154800,2665,3474,13778900,3966,4375900
6,04/03/2022,18.4 (-0.54 %),3989,11305900,2834,4791,12151400,2536,-845500
7,03/03/2022,18.5 (4.52 %),5242,19271800,3676,7079,20543100,2902,-1271300
8,02/03/2022,17.65 (-1.94 %),3726,7802700,2094,2539,11562000,4554,-3759300
9,01/03/2022,18 (1.69 %),3178,9552600,3006,3489,12239300,3508,-2686700
10,28/02/2022,17.65 (-0.84 %),3284,6549500,1994,2039,8366700,4103,-1817200
11,25/02/2022,17.8 (1.14 %),3511,6932600,1975,2369,8497800,3587,-1565200
12,24/02/2022,17.55 (-3.57 %),6046,12872000,2129,3393,15280700,4504,-2408700
13,23/02/2022,18.15 (0.28 %),2363,6300200,2666,2394,8126500,3395,-1826300
14,22/02/2022,18.05 (-3.48 %),5058,10555800,2087,2856,12582800,4406,-2027000
15,21/02/2022,18.65 (3.04 %),4601,12589600,2736,4210,12119300,2879,470300
16,18/02/2022,18.1 (0.00 %),3501,7590400,2168,2969,8733800,2942,-1143400
17,17/02/2022,18.05 (0.28 %),3309,9388600,2837,3312,10288700,3106,-900100
18,16/02/2022,18 (3.45 %),3078,9135800,2968,3267,9102800,2786,33000
19,15/02/2022,17.4 (0.00 %),2664,5942400,2231,1662,6481900,3900,-539500
20,14/02/2022,17.35 (-3.07 %),3814,8757200,2296,1939,9687900,4996,-930700
1,11/02/2022,17.9 (0.56 %),2855,9387600,3288,2588,8132500,3142,1255100
2,10/02/2022,17.8 (0.00 %),3934,8934300,2271,3203,10656900,3327,-1722600
3,09/02/2022,17.75 (2.01 %),3070,7932700,2584,2414,7671100,3178,261600
4,08/02/2022,17.4 (0.00 %),2775,5944800,2142,2137,7600100,3556,-1655300
5,07/02/2022,17.35 (5.15 %),3285,7586000,2309,1592,5820300,3656,1765700
6,28/01/2022,16.5 (-0.60 %),2342,5152500,2200,1409,5636600,4000,-484100
7,27/01/2022,16.6 (0.00 %),2084,5841400,2803,1354,4944400,3652,897000
8,26/01/2022,16.55 (-2.65 %),2325,4860300,2090,1643,8363400,5090,-3503100
9,25/01/2022,17 (2.41 %),0,0,,0,0,,0
10,24/01/2022,16.55 (-7.02 %),4300,10839300,2521,2163,13754900,6359,-2915600
11,21/01/2022,17.75 (-1.93 %),3247,8257600,2543,2035,8588300,4220,-330700
12,20/01/2022,18.05 (2.56 %),3002,12428300,4140,2307,8798300,3814,3630000
13,19/01/2022,17.4 (-1.14 %),2808,5946600,2118,1911,8366700,4378,-2420100
14,18/01/2022,17.6 (2.92 %),4161,14265200,3428,3370,9736900,2889,4528300
15,17/01/2022,17.1 (-6.81 %),4996,16119900,3227,3484,17256500,4953,-1136600
16,14/01/2022,18.35 (0.27 %),5849,15878700,2715,2961,11464500,3872,4414200
17,13/01/2022,18.25 (-6.89 %),4307,13368600,3104,2920,13145700,4502,222900
18,12/01/2022,19.6 (-2.00 %),7913,21945400,2773,4944,20860800,4219,1084600
19,11/01/2022,20 (-6.10 %),9946,21203200,2132,4236,22530800,5319,-1327600
20,10/01/2022,21.25 (-6.80 %),7516,17337100,2307,5359,20230900,3775,-2893800
1,07/01/2022,22.8 (1.79 %),5776,11954900,2070,5042,14699800,2915,-2744900
2,06/01/2022,22.4 (6.67 %),6213,21808400,3510,5367,16537500,3081,5270900
3,05/01/2022,20.95 (1.21 %),4319,13591400,3147,4754,13647200,2871,-55800
4,04/01/2022,20.7 (2.48 %),5042,15765400,3127,3819,11993200,3140,3772200
5,31/12/2021,20.2 (-3.81 %),6806,15175400,2230,4946,19186300,3879,-4010900
6,30/12/2021,21 (-2.78 %),3298,8754600,2655,3081,10244100,3325,-1489500
7,29/12/2021,21.55 (1.17 %),4948,13656800,2760,3931,15393200,3916,-1736400
8,28/12/2021,21.3 (-2.74 %),6573,18171100,2765,5096,19379000,3803,-1207900
9,27/12/2021,21.9 (2.34 %),4233,16042600,3790,5369,16018300,2983,24300
10,24/12/2021,21.35 (-0.23 %),8186,19682800,2404,5938,19940800,3358,-258000
11,23/12/2021,21.4 (7.00 %),8238,26816700,3255,8408,32885800,3911,-6069100
12,22/12/2021,20 (3.09 %),7805,18535500,2375,7082,19673500,2778,-1138000
13,21/12/2021,19.35 (6.91 %),7583,30353400,4003,5845,19855100,3397,10498300
14,20/12/2021,18.1 (-2.69 %),4670,11529000,2469,3793,14235100,3753,-2706100
15,17/12/2021,18.6 (-0.53 %),4211,11142000,2646,6434,19046800,2960,-7904800
16,16/12/2021,18.7 (1.08 %),4353,18343800,4214,7497,20160400,2689,-1816600
17,15/12/2021,18.5 (0.82 %),5175,21179900,4093,11138,27470800,2466,-6290900
18,14/12/2021,18.35 (3.97 %),4815,18011600,3741,7404,19366100,2616,-1354500
19,13/12/2021,17.65 (3.82 %),4453,16326200,3666,6080,16192600,2663,133600
20,10/12/2021,17 (1.19 %),2503,8317900,3323,2955,9055800,3065,-737900
1,09/12/2021,16.8 (1.20 %),2027,6337400,3126,2113,5570200,2636,767200
2,08/12/2021,16.6 (0.30 %),2342,8603300,3673,2717,7686300,2829,917000
3,07/12/2021,16.55 (1.85 %),2573,9742400,3786,1959,6206700,3168,3535700
4,06/12/2021,16.25 (-3.85 %),3809,10884400,2858,2442,11963700,4899,-1079300
5,03/12/2021,16.9 (-3.70 %),3253,8663200,2663,3016,11390300,3777,-2727100
6,02/12/2021,17.55 (0.86 %),4153,11759600,2832,5452,14936100,2740,-3176500
7,01/12/2021,17.4 (3.26 %),2813,15417400,5481,4139,10299700,2488,5117700
8,30/11/2021,16.85 (0.30 %),3656,12556800,3435,3449,11427900,3313,1128900
9,29/11/2021,16.8 (-0.59 %),4914,11761900,2394,2457,8474200,3449,3287700
10,26/11/2021,16.9 (-1.17 %),3955,10514600,2659,3010,9723200,3230,791400
11,25/11/2021,17.1 (0.59 %),3625,10226500,2821,2996,9790700,3268,435800
12,24/11/2021,17 (-0.58 %),5169,12056100,2332,2952,11015400,3732,1040700
13,23/11/2021,17.1 (3.01 %),4161,9433000,2267,2319,6970100,3006,2462900
14,22/11/2021,16.6 (-5.14 %),5472,14020500,2562,4096,16032300,3914,-2011800
15,19/11/2021,17.5 (-5.91 %),6480,18170000,2804,6142,24368600,3968,-6198600
16,18/11/2021,18.6 (3.91 %),6032,16497700,2735,5940,17946000,3021,-1448300
17,17/11/2021,17.9 (0.56 %),3887,11674200,3003,3636,11305400,3109,368800
18,16/11/2021,17.8 (-3.26 %),6961,15316500,2200,3662,16109200,4399,-792700
19,15/11/2021,18.4 (0.55 %),5904,17852100,3024,6012,19349000,3218,-1496900
20,12/11/2021,18.3 (1.67 %),5557,15698400,2825,6354,17841000,2808,-2142600
1,11/11/2021,18 (-0.83 %),5814,15768300,2712,5889,18283300,3105,-2515000
2,10/11/2021,18.15 (6.14 %),0,0,,0,0,,0
3,09/11/2021,17.1 (-0.87 %),3862,12720600,3294,5559,18031400,3244,-5310800
4,08/11/2021,17.25 (1.47 %),4393,11990100,2729,5398,17279100,3201,-5289000
5,05/11/2021,17 (2.41 %),3885,10955600,2820,4054,12225000,3016,-1269400
6,04/11/2021,16.6 (-0.60 %),4766,10814100,2269,2854,10085500,3534,728600
7,03/11/2021,16.7 (-4.57 %),6781,17759700,2619,6001,23665000,3944,-5905300
8,02/11/2021,17.5 (-0.28 %),3888,11417200,2937,5487,17746900,3234,-6329700
9,01/11/2021,17.55 (2.03 %),7163,22678500,3166,6920,24268000,3507,-1589500
10,29/10/2021,17.2 (1.78 %),4689,14005400,2987,7512,19547000,2602,-5541600
11,28/10/2021,16.9 (-1.17 %),5055,11878500,2350,6029,17163000,2847,-5284500
12,27/10/2021,17.1 (5.56 %),9810,37737300,3847,12795,33138600,2590,4598700
13,26/10/2021,16.2 (0.31 %),3208,11827100,3687,2519,7918600,3144,3908500
14,25/10/2021,16.15 (0.00 %),2881,9954200,3455,4617,13345700,2891,-3391500
15,22/10/2021,16.15 (1.57 %),2810,8845300,3148,3564,9649600,2708,-804300
16,21/10/2021,15.9 (-0.62 %),3538,10058300,2843,2250,8791300,3907,1267000
17,20/10/2021,16 (-0.62 %),3755,9029100,2405,3062,10508300,3432,-1479200
18,19/10/2021,16.1 (-0.31 %),3318,10276300,3097,3148,9144200,2905,1132100
19,18/10/2021,16.15 (-1.22 %),2926,7815600,2671,3407,10244400,3007,-2428800
20,15/10/2021,16.35 (-1.21 %),3565,19742500,5538,5231,14321400,2738,5421100
1,14/10/2021,16.55 (1.85 %),6241,24817800,3977,9490,22241300,2344,2576500
2,13/10/2021,16.25 (0.00 %),2821,8197000,2906,4656,10497000,2255,-2300000
3,12/10/2021,16.25 (0.31 %),3545,11242200,3171,5391,11319200,2100,-77000
4,11/10/2021,16.2 (0.00 %),2726,9234400,3388,2909,8328600,2863,905800
5,08/10/2021,16.2 (-2.11 %),2617,5063600,1935,3649,8798200,2411,-3734600
6,07/10/2021,16.55 (2.80 %),5711,15895000,2783,6513,17233100,2646,-1338100
7,06/10/2021,16.1 (0.63 %),2110,7231400,3427,3596,10236100,2847,-3004700
8,05/10/2021,16 (1.91 %),2915,8628300,2960,4008,11464200,2860,-2835900
9,04/10/2021,15.7 (0.96 %),2556,6210700,2430,2465,6447000,2615,-236300
10,01/10/2021,15.55 (-0.96 %),3296,7925600,2405,2377,8966200,3772,-1040600
11,30/09/2021,15.7 (0.00 %),2446,7129600,2915,1838,6486000,3529,643600
12,29/09/2021,15.7 (-0.32 %),4029,11339000,2814,1803,5820600,3228,5518400
13,28/09/2021,15.75 (1.29 %),5648,12980600,2298,3321,12104700,3645,875900
14,27/09/2021,15.55 (-4.60 %),5549,12525200,2257,3195,17381700,5440,-4856500
15,24/09/2021,16.3 (-1.81 %),3013,8151800,2706,3229,9047100,2802,-895300
16,23/09/2021,16.6 (0.61 %),6433,15987100,2485,8459,21696200,2565,-5709100
17,22/09/2021,16.5 (2.80 %),4198,14582500,3474,4757,13152200,2765,1430300
18,21/09/2021,16.05 (-0.93 %),4874,14328500,2940,2654,10331200,3893,3997300
19,20/09/2021,16.2 (-2.11 %),3901,8177900,2096,3950,10612200,2687,-2434300
20,17/09/2021,16.55 (3.44 %),8425,22590000,2681,7977,22015900,2760,574100
1,16/09/2021,16 (-0.62 %),2666,10113800,3794,2856,8472800,2967,1641000
2,15/09/2021,16.1 (1.90 %),3759,9891700,2631,3068,8022500,2615,1869200
3,14/09/2021,15.8 (-1.56 %),3106,6796200,2188,3282,9250800,2819,-2454600
4,13/09/2021,16.05 (-1.53 %),3163,7354100,2325,3417,11000900,3219,-3646800
5,10/09/2021,16.3 (0.93 %),4295,11645800,2711,3892,12545800,3223,-900000
6,09/09/2021,16.15 (1.57 %),3104,8757700,2821,2957,7568200,2559,1189500
7,08/09/2021,15.9 (-0.62 %),5296,12823400,2421,2762,9946700,3601,2876700
8,07/09/2021,16 (-3.90 %),6846,14034600,2050,3943,16165100,4100,-2130500
9,06/09/2021,16.65 (2.78 %),6798,17846900,2625,3998,17072100,4270,774800
10,01/09/2021,16.2 (-8.73 %),8215,21045900,2562,4177,19292100,4619,1753800
11,31/08/2021,17.75 (0.28 %),6726,20342500,3024,9258,27816900,3005,-7474400
12,30/08/2021,17.7 (-0.84 %),4085,13687000,3351,6709,20572000,3066,-6885000
13,27/08/2021,17.85 (4.08 %),6132,19861200,3239,5640,17505300,3104,2355900
14,26/08/2021,17.15 (0.29 %),2741,9212800,3361,2818,8902200,3159,310600
15,25/08/2021,17.1 (1.79 %),3471,9999800,2881,2326,7379500,3173,2620300
16,24/08/2021,16.8 (0.00 %),4538,11864400,2614,3718,9807400,2638,2057000
17,23/08/2021,16.8 (-3.45 %),5588,15643500,2799,3897,14118000,3623,1525500
18,20/08/2021,17.4 (-4.66 %),8801,21548400,2448,5696,30062400,5278,-8514000
19,19/08/2021,18.25 (3.40 %),7697,18855500,2450,5391,18647200,3459,208300
20,18/08/2021,17.65 (-0.28 %),3597,8932700,2483,2974,9572600,3219,-639900
1,17/08/2021,17.7 (-1.67 %),4505,12298500,2730,3534,12982100,3673,-683600
2,16/08/2021,18 (3.75 %),7154,25170400,3518,5932,19959700,3365,5210700
3,13/08/2021,17.35 (0.58 %),3997,12438500,3112,3712,11446700,3084,991800
4,12/08/2021,17.25 (1.47 %),5082,14536500,2860,4582,14149600,3088,386900
5,11/08/2021,17 (-2.02 %),5417,14411300,2660,5845,18584100,3179,-4172800
6,10/08/2021,17.3 (0.29 %),3603,11072100,3073,4852,14049000,2896,-2976900
7,09/08/2021,17.25 (1.17 %),3787,11672000,3082,4618,14901600,3227,-3229600
8,06/08/2021,17.05 (3.65 %),7602,28261300,3718,7180,22748000,3168,5513300
9,05/08/2021,16.45 (1.54 %),4182,10948700,2618,3373,10550200,3128,398500
10,04/08/2021,16.2 (-0.31 %),3886,10530500,2710,2802,11260300,4019,-729800
11,03/08/2021,16.25 (0.00 %),3728,11010100,2953,2452,11439200,4665,-429100
12,02/08/2021,16.25 (0.62 %),4666,14380100,3082,3493,14057600,4025,322500
13,30/07/2021,16.15 (0.00 %),2929,8654400,2955,2471,8184200,3312,470200
14,29/07/2021,16.15 (-0.92 %),2659,8612400,3239,2401,9251000,3853,-638600
15,28/07/2021,16.3 (1.88 %),3665,19170400,5231,3239,12203400,3768,6967000
16,27/07/2021,16 (3.56 %),5022,25252000,5028,3895,16830100,4321,8421900
17,26/07/2021,15.45 (-0.64 %),2411,7038200,2919,1534,4752400,3098,2285800
18,23/07/2021,15.55 (-2.51 %),2760,11485000,4161,2485,11773100,4738,-288100
19,22/07/2021,15.95 (3.24 %),2739,18902700,6901,2597,10229400,3939,8673300
20,21/07/2021,15.45 (0.00 %),2392,15949400,6668,2453,9016000,3675,6933400
1,20/07/2021,15.45 (4.39 %),2671,14562100,5452,2200,7223800,3284,7338300
2,19/07/2021,14.8 (-6.03 %),3796,12697200,3345,2440,9706300,3978,2990900
3,16/07/2021,15.75 (-1.25 %),3006,9458000,3146,1849,7906100,4276,1551900
4,15/07/2021,15.95 (2.57 %),3341,20655500,6182,2763,8767400,3173,11888100
5,14/07/2021,15.55 (-2.20 %),2957,7919800,2678,1692,6749200,3989,1170600
6,13/07/2021,15.9 (3.25 %),3301,13340100,4041,2586,6878700,2660,6461400
7,12/07/2021,15.4 (-4.35 %),4691,16930800,3609,3587,17046900,4752,-116100
8,09/07/2021,16.1 (-3.59 %),5525,13556400,2454,3164,11890000,3758,1666400
9,08/07/2021,16.7 (-3.47 %),0,0,,0,0,,0
10,07/07/2021,17.3 (0.00 %),6751,18943900,2806,3640,15800200,4341,3143700
11,06/07/2021,17.3 (-6.74 %),0,0,,0,0,,0
12,02/07/2021,18.65 (-4.11 %),0,0,,0,0,,0
13,01/07/2021,19.45 (-0.26 %),6632,27757400,4185,2841,16228100,5712,11529300
14,30/06/2021,19.5 (-4.88 %),7888,37982700,4815,2867,20756300,7240,17226400
15,29/06/2021,20.5 (3.80 %),6244,49122300,7867,5614,34705000,6182,14417300
16,28/06/2021,19.75 (6.76 %),0,0,,0,0,,0
17,25/06/2021,18.5 (-2.89 %),5249,26161500,4984,3333,27844500,8354,-1683000
18,24/06/2021,19.05 (0.26 %),3537,30635000,8661,3626,25189700,6947,5445300
19,23/06/2021,19 (-2.56 %),3964,29597100,7466,4657,29624800,6361,-27700
20,22/06/2021,0 (0.00 %),4931,47723200,9678,5104,32987800,6463,14735400
1,21/06/2021,19.9 (2.31 %),5461,49137800,8998,5140,27697700,5389,21440100
2,18/06/2021,19.45 (1.57 %),6618,58423800,8828,7352,33001300,4489,25422500
3,17/06/2021,19.15 (6.98 %),6004,60409200,10061,4833,28050900,5804,32358300
4,16/06/2021,17.9 (3.77 %),5060,33702100,6660,5326,23667100,4444,10035000
5,15/06/2021,17.25 (6.81 %),7652,42479600,5551,5180,23556200,4548,18923400
6,14/06/2021,16.15 (0.31 %),1976,6725300,3403,2467,8960300,3632,-2235000
7,11/06/2021,16.1 (2.55 %),2233,7864100,3522,3204,8175000,2551,-310900
8,10/06/2021,15.7 (1.29 %),1750,6089700,3480,1290,6167200,4781,-77500
9,09/06/2021,15.5 (0.32 %),2383,7914900,3321,1319,6062300,4596,1852600
10,08/06/2021,15.45 (-3.44 %),2144,6713200,3131,1882,9019800,4793,-2306600
11,07/06/2021,16 (-1.84 %),1224,3664500,2994,1727,5602600,3244,-1938100
12,04/06/2021,16.3 (0.31 %),2338,8139300,3481,2571,10638600,4138,-2499300
13,03/06/2021,16.25 (6.91 %),0,0,,0,0,,0
14,02/06/2021,15.2 (0.33 %),1775,5134000,2892,1087,4475200,4117,658800
15,01/06/2021,15.15 (-0.66 %),1007,3853500,3827,1500,5296000,3531,-1442500
16,31/05/2021,15.25 (-0.65 %),1354,3916000,2892,1439,5332800,3706,-1416800
17,28/05/2021,15.35 (1.32 %),2066,7485200,3623,1589,7307600,4599,177600
18,27/05/2021,15.15 (-2.26 %),1662,6165200,3710,1546,7538700,4876,-1373500
19,26/05/2021,15.5 (-1.59 %),1860,6116000,3288,1727,7714900,4467,-1598900
20,25/05/2021,15.75 (0.96 %),1648,5550500,3368,2356,8131600,3451,-2581100
1,24/05/2021,15.6 (1.96 %),2456,11325800,4611,2433,11341100,4661,-15300
2,21/05/2021,15.3 (3.03 %),2342,8775200,3747,1702,7500600,4407,1274600
3,20/05/2021,14.85 (-1.66 %),2098,4602500,2194,1973,5868800,2975,-1266300
4,19/05/2021,15.1 (-0.33 %),2080,5538200,2663,1890,6690000,3540,-1151800
5,18/05/2021,15.15 (-0.98 %),1971,4912100,2492,1366,5894500,4315,-982400
6,17/05/2021,15.3 (-1.61 %),1787,4900000,2742,1446,6645000,4595,-1745000
7,14/05/2021,15.55 (0.32 %),2450,7159700,2922,1749,7943700,4542,-784000
8,13/05/2021,15.5 (-1.90 %),2230,5879800,2637,1524,8601900,5644,-2722100
9,12/05/2021,15.8 (0.64 %),2116,7440600,3516,1329,7788000,5860,-347400
10,11/05/2021,15.7 (0.00 %),2016,6152300,3052,1331,6389100,4800,-236800
11,10/05/2021,15.7 (2.28 %),2738,11742400,4289,1639,9489600,5790,2252800
12,07/05/2021,15.35 (-3.15 %),3182,8088000,2542,1416,12450400,8793,-4362400
13,06/05/2021,15.85 (-2.76 %),2757,6424100,2330,1230,9081800,7384,-2657700
14,05/05/2021,16.3 (1.88 %),2978,11333200,3806,1637,11300800,6903,32400
15,04/05/2021,16 (-2.74 %),2293,7684000,3351,1183,6086500,5145,1597500
16,29/04/2021,16.45 (-1.50 %),1366,4761600,3486,1366,8270100,6054,-3508500
17,28/04/2021,16.7 (0.00 %),1880,18503100,9842,2335,13484700,5775,5018400
18,27/04/2021,16.7 (4.38 %),2512,24826100,9883,2133,13958300,6544,10867800
19,23/04/2021,16.75 (2.76 %),3275,12681600,3872,1687,11454200,6790,1227400
20,22/04/2021,0 (0.00 %),1995,6851400,3434,1660,10552200,6357,-3700800
1,20/04/2021,17.5 (-1.41 %),2244,8359700,3725,2357,12551200,5325,-4191500
2,19/04/2021,17.75 (-0.56 %),2328,12693200,5452,2492,13599600,5457,-906400
3,16/04/2021,17.85 (-0.28 %),2246,9555900,4255,2372,10827400,4565,-1271500
4,15/04/2021,17.9 (0.28 %),2962,13492400,4555,3399,13794200,4058,-301800
5,14/04/2021,17.85 (5.00 %),4283,21963000,5128,3631,14803300,4077,7159700
6,13/04/2021,17 (-2.86 %),2668,9070400,3400,2422,12344400,5097,-3274000
7,12/04/2021,17.5 (0.00 %),2150,6849400,3186,2499,9113300,3647,-2263900
8,09/04/2021,17.5 (4.17 %),3778,21741000,5755,3396,12991500,3826,8749500
9,08/04/2021,16.8 (1.82 %),2505,10735500,4286,2345,10286100,4386,449400
10,07/04/2021,16.5 (0.61 %),1631,5219500,3200,1146,5355100,4673,-135600
11,06/04/2021,16.4 (-0.91 %),1421,4898200,3447,1314,6339200,4824,-1441000
12,05/04/2021,16.55 (-0.60 %),1176,5066900,4309,1746,7673200,4395,-2606300
13,02/04/2021,16.65 (0.00 %),1359,6060200,4459,1827,9005600,4929,-2945400
14,01/04/2021,16.65 (0.30 %),1102,5451900,4947,1502,6612200,4402,-1160300
15,31/03/2021,16.6 (0.91 %),1400,6938500,4956,1758,6950200,3953,-11700
16,30/03/2021,16.45 (1.23 %),1586,6842700,4314,2098,7915600,3773,-1072900
17,29/03/2021,16.25 (1.88 %),1802,9007600,4999,1521,7472300,4913,1535300
18,26/03/2021,15.95 (0.31 %),1709,8611400,5039,1307,7468600,5714,1142800
19,25/03/2021,15.9 (1.27 %),1645,7363500,4476,1171,5673800,4845,1689700
20,24/03/2021,15.7 (-3.98 %),2284,5819600,2548,1378,8874800,6440,-3055200
1,23/03/2021,16.35 (-2.10 %),1918,5384000,2807,1393,7460600,5356,-2076600
2,22/03/2021,16.7 (0.00 %),1586,4952700,3123,1242,6162600,4962,-1209900
3,19/03/2021,16.7 (0.00 %),1397,5165800,3698,1401,6246400,4459,-1080600
4,18/03/2021,16.7 (0.60 %),1704,8036900,4716,2012,9560500,4752,-1523600
5,17/03/2021,16.6 (-2.35 %),1959,6844900,3494,1767,7683400,4348,-838500
6,16/03/2021,17 (1.49 %),2351,10806800,4597,2799,9199900,3287,1606900
7,15/03/2021,16.75 (3.72 %),2937,1647640,561,3746,1233320,329,414320
8,12/03/2021,16.15 (-0.31 %),1632,5706600,3497,2146,6223700,2900,-517100
9,11/03/2021,16.2 (3.18 %),2554,9471100,3708,3506,13318800,3799,-3847700
10,10/03/2021,15.7 (6.80 %),4358,29687400,6812,3326,12966000,3898,16721400
11,09/03/2021,14.7 (0.00 %),0,0,,0,0,,0
12,08/03/2021,14.7 (0.68 %),1027,440510,429,1698,624910,368,-184400
13,05/03/2021,14.6 (2.10 %),1880,7370800,3921,1268,6078900,4794,1291900
14,04/03/2021,14.3 (-3.38 %),1469,4450500,3030,1403,6739700,4804,-2289200
15,03/03/2021,14.8 (0.00 %),1456,4465600,3067,1361,6486600,4766,-2021000
16,02/03/2021,14.8 (-0.34 %),1715,495490,289,1712,755840,441,-260350
17,01/03/2021,14.85 (3.85 %),2644,9970100,3771,2232,7090900,3177,2879200
18,26/02/2021,14.3 (0.00 %),1193,5291600,4436,1017,4154200,4085,1137400
19,25/02/2021,14.3 (2.14 %),1226,5953400,4856,1267,4919200,3883,1034200
20,24/02/2021,14 (-1.75 %),1748,5443000,3114,1273,6231100,4895,-788100
1,23/02/2021,14.25 (-1.04 %),1752,6044100,3450,1160,5960900,5139,83200
2,22/02/2021,14.4 (0.70 %),1427,6361800,4458,2021,8455100,4184,-2093300
3,19/02/2021,14.3 (1.06 %),1464,6004100,4101,1741,6443300,3701,-439200
4,18/02/2021,14.15 (3.66 %),1745,7392500,4236,1496,5564500,3720,1828000
5,17/02/2021,13.65 (5.00 %),1587,5318000,3351,1111,4700400,4231,617600
6,09/02/2021,13 (1.17 %),1178,378320,321,714,554890,777,-176570
7,08/02/2021,12.85 (-3.02 %),1150,384460,334,885,454340,513,-69880
8,05/02/2021,13.25 (-0.38 %),1134,3344500,2949,880,4077600,4634,-733100
9,04/02/2021,13.3 (0.00 %),1342,4301900,3206,1021,5368200,5258,-1066300
10,03/02/2021,13.3 (6.40 %),1404,4915000,3501,873,4039600,4627,875400
11,02/02/2021,12.5 (2.46 %),1570,7416600,4724,1072,5033600,4696,2383000
12,01/02/2021,12.2 (-6.87 %),2035,6923600,3402,1027,8712300,8483,-1788700
13,29/01/2021,13.1 (1.16 %),1516,4893700,3228,977,5114700,5235,-221000
14,28/01/2021,12.95 (-6.83 %),1146,5219400,4554,1429,11029300,7718,-5809900
15,27/01/2021,13.9 (-3.47 %),1355,5723500,4224,1221,7283100,5965,-1559600
16,26/01/2021,14.4 (-2.04 %),1222,544770,446,997,523100,525,21670
17,25/01/2021,14.7 (1.73 %),1257,710640,565,1334,590490,443,120150
18,22/01/2021,14.45 (-1.70 %),1208,392880,325,1156,594070,514,-201190
19,21/01/2021,14.7 (3.16 %),1336,5029800,3765,902,4448300,4932,581500
20,20/01/2021,14.25 (-1.04 %),1616,6993100,4327,1262,6211600,4922,781500
1,19/01/2021,14.4 (-6.80 %),1929,6644500,3445,1461,10868100,7439,-4223600
2,18/01/2021,15.45 (-0.96 %),1386,4424900,3193,1239,7288700,5883,-2863800
3,15/01/2021,15.6 (0.97 %),1492,6769100,4537,1684,7928800,4708,-1159700
4,14/01/2021,15.45 (0.32 %),1845,10084200,5466,1579,8098600,5129,1985600
5,13/01/2021,15.4 (-0.65 %),1820,8031400,4413,1670,10611000,6354,-2579600
6,12/01/2021,15.5 (-1.90 %),2041,7365200,3609,1551,8839100,5699,-1473900
7,11/01/2021,15.8 (4.29 %),2007,10351300,5158,2078,10100900,4861,250400
8,08/01/2021,15.15 (-0.33 %),1709,8339600,4880,1557,8726800,5605,-387200
9,07/01/2021,15.2 (4.47 %),2131,15897600,7460,2060,10135700,4920,5761900
10,06/01/2021,14.55 (0.34 %),1558,7267000,4664,1443,7933400,5498,-666400
11,05/01/2021,14.5 (-0.34 %),1353,5674400,4194,1234,5950100,4822,-275700
12,04/01/2021,14.55 (1.04 %),0,0,,0,0,,0
13,31/12/2020,14.4 (-0.35 %),0,0,,0,0,,0
14,30/12/2020,14.45 (3.21 %),2223,11178970,5029,2258,8870690,3929,2308280
15,29/12/2020,14 (-0.71 %),1837,6718710,3657,1637,7374130,4505,-655420
16,28/12/2020,14.1 (0.71 %),1428,4963740,3476,1571,8156870,5192,-3193130
17,25/12/2020,14 (3.70 %),2009,7484980,3726,1521,6498270,4272,986710
18,24/12/2020,13.5 (-4.26 %),2441,8258550,3383,1630,9579420,5877,-1320870
19,23/12/2020,14.1 (-2.42 %),1268,4542860,3583,1583,7250420,4580,-2707560
20,22/12/2020,14.45 (1.40 %),0,0,,0,0,,0
1,21/12/2020,14.25 (6.74 %),2406,17089270,7103,2742,9878660,3603,7210610
2,18/12/2020,13.35 (1.14 %),1114,4141640,3718,1386,7093130,5118,-2951490
3,17/12/2020,13.2 (-1.12 %),2332,6819750,2924,1168,7058800,6043,-239050
4,16/12/2020,13.35 (0.38 %),1113,5874780,5278,1912,8072040,4222,-2197260
5,15/12/2020,13.3 (1.92 %),1723,9467300,5495,2224,8393830,3774,1073470
6,14/12/2020,13.05 (0.77 %),1382,8563140,6196,1857,6840620,3684,1722520
7,11/12/2020,12.95 (0.78 %),1468,5456710,3717,1055,4583100,4344,873610
8,10/12/2020,12.85 (-3.02 %),1501,4424300,2948,1429,7674710,5371,-3250410
9,09/12/2020,13.25 (2.71 %),1735,9628430,5550,2834,9446010,3333,182420
10,08/12/2020,12.9 (-0.39 %),0,0,,0,0,,0
11,07/12/2020,12.95 (1.17 %),1127,6426130,5702,1814,6988200,3852,-562070
12,04/12/2020,12.8 (-0.78 %),1523,5283470,3469,2130,8783360,4124,-3499890
13,03/12/2020,12.9 (0.00 %),1196,4264500,3566,1463,5067040,3463,-802540
14,02/12/2020,12.9 (2.38 %),1886,11394860,6042,3137,9507360,3031,1887500
15,01/12/2020,12.6 (-0.79 %),1939,6876280,3546,1824,6454220,3538,422060
16,30/11/2020,12.7 (3.67 %),2281,14124470,6192,4638,11614120,2504,2510350
17,27/11/2020,12.25 (0.41 %),1164,4867520,4182,2057,4707750,2289,159770
18,26/11/2020,12.2 (1.24 %),1287,5297620,4116,1610,6105110,3792,-807490
19,25/11/2020,12.05 (-0.41 %),1016,3637690,3580,1348,4860930,3606,-1223240
20,23/11/2020,0 (0.00 %),958,3757240,3922,1546,5071950,3281,-1314710
1,20/11/2020,12.3 (0.00 %),1673,6206020,3710,3252,11026620,3391,-4820600
2,19/11/2020,12.3 (6.96 %),2172,12726920,5860,2144,7136180,3328,5590740
3,18/11/2020,11.5 (0.44 %),779,2737570,3514,1039,3650080,3513,-912510
4,17/11/2020,11.45 (2.23 %),880,3387340,3849,913,2577050,2823,810290
5,16/11/2020,11.2 (-0.44 %),920,2236180,2431,798,2769400,3470,-533220
6,13/11/2020,11.25 (-0.44 %),883,2103020,2382,699,2197660,3144,-94640
7,12/11/2020,11.3 (0.00 %),552,1699550,3079,691,2291780,3317,-592230
8,11/11/2020,11.3 (0.89 %),592,1986620,3356,779,2567020,3295,-580400
9,10/11/2020,11.2 (-0.44 %),644,1756720,2728,774,2840650,3670,-1083930
10,09/11/2020,11.25 (2.27 %),846,2716080,3210,1016,2823340,2779,-107260
11,06/11/2020,11 (0.00 %),546,1225920,2245,453,1451800,3205,-225880
12,05/11/2020,11 (-1.79 %),946,2316500,2449,504,1781360,3534,535140
13,04/11/2020,11.2 (1.82 %),784,2181980,2783,565,1938060,3430,243920
14,03/11/2020,11 (0.00 %),805,1471270,1828,441,1344560,3049,126710
15,02/11/2020,11 (0.92 %),623,1406560,2258,322,1435670,4459,-29110
16,30/10/2020,10.9 (0.46 %),782,1721390,2201,411,2207650,5371,-486260
17,29/10/2020,10.85 (0.46 %),1054,2416690,2293,580,2168780,3739,247910
18,28/10/2020,10.8 (-4.00 %),0,0,,0,0,,0
19,27/10/2020,11.25 (-2.60 %),0,0,,0,0,,0
20,26/10/2020,11.55 (-0.86 %),584,1937080,3317,832,3277200,3939,-1340120
1,23/10/2020,11.65 (-0.43 %),796,2134500,2682,736,3786060,5144,-1651560
2,22/10/2020,11.7 (0.00 %),891,2642950,2966,647,2833420,4379,-190470
3,21/10/2020,11.7 (-1.27 %),905,2065780,2283,830,4027260,4852,-1961480
4,20/10/2020,11.85 (-0.42 %),949,2703480,2849,719,3804560,5291,-1101080
5,19/10/2020,11.9 (-3.25 %),1383,3650130,2639,919,5032850,5476,-1382720
6,16/10/2020,12.3 (0.82 %),999,3603890,3607,1188,5261910,4429,-1658020
7,15/10/2020,12.2 (-0.41 %),1058,2823880,2669,870,4147290,4767,-1323410
8,14/10/2020,12.25 (0.82 %),1032,3234370,3134,856,3619580,4228,-385210
9,13/10/2020,12.15 (0.00 %),1033,2450840,2373,755,3333580,4415,-882740
10,12/10/2020,12.15 (-0.82 %),1146,2879890,2513,913,4368240,4784,-1488350
11,09/10/2020,12.25 (0.41 %),1122,4106880,3660,1089,4655040,4275,-548160
12,08/10/2020,12.2 (-1.21 %),1707,4580020,2683,1032,5492140,5322,-912120
13,07/10/2020,12.35 (-1.59 %),965,3532350,3660,1496,5912520,3952,-2380170
14,06/10/2020,12.55 (0.80 %),1444,7954460,5509,2489,10416120,4185,-2461660
15,05/10/2020,12.45 (2.47 %),1535,8874510,5781,2512,9181230,3655,-306720
16,02/10/2020,12.15 (-0.82 %),1618,5133030,3172,1559,7135100,4577,-2002070
17,01/10/2020,12.25 (0.82 %),1033,3094900,2996,1240,5895100,4754,-2800200
18,30/09/2020,12.15 (0.41 %),1113,3498060,3143,1013,3835740,3787,-337680
19,29/09/2020,12.1 (-1.63 %),1501,5889360,3924,1499,7462390,4978,-1573030
20,28/09/2020,12.3 (0.41 %),1201,3495320,2910,1063,4875910,4587,-1380590
1,25/09/2020,12.25 (-1.21 %),1028,2385380,2320,1249,5020500,4020,-2635120
2,24/09/2020,12.4 (0.00 %),1648,7205850,4372,2273,8551260,3762,-1345410
3,23/09/2020,12.4 (2.06 %),1827,6842040,3745,1766,6344260,3592,497780
4,22/09/2020,12.15 (0.00 %),0,0,,0,0,,0
5,21/09/2020,12.15 (-0.82 %),1596,5049190,3164,1473,7286110,4946,-2236920
6,18/09/2020,12.25 (-0.41 %),1029,2581150,2508,1039,4982220,4795,-2401070
7,17/09/2020,12.3 (0.82 %),1662,5546590,3337,1760,6952060,3950,-1405470
8,16/09/2020,12.2 (-0.41 %),1481,4237980,2862,966,4986210,5162,-748230
9,15/09/2020,12.25 (-0.81 %),1187,3821680,3220,1017,5191350,5105,-1369670
10,14/09/2020,12.35 (-1.59 %),1961,5539990,2825,1277,4950900,3877,589090
11,11/09/2020,12.55 (-0.40 %),1362,5800900,4259,1458,6851850,4699,-1050950
12,10/09/2020,12.6 (-0.79 %),904,2813770,3113,1376,4765070,3463,-1951300
13,09/09/2020,12.7 (0.40 %),1234,5027000,4074,1094,3873230,3540,1153770
14,08/09/2020,12.65 (0.40 %),1143,4271420,3737,1295,4632630,3577,-361210
15,07/09/2020,12.6 (0.40 %),1997,7339200,3675,2112,6676930,3161,662270
16,04/09/2020,12.55 (0.40 %),2231,7549720,3384,1007,4222640,4193,3327080
17,03/09/2020,12.5 (0.00 %),1403,5014710,3574,1094,4572650,4180,442060
18,01/09/2020,12.5 (-0.40 %),1757,5108930,2908,948,5042960,5320,65970
19,31/08/2020,12.55 (0.00 %),1916,7571600,3952,1974,7963340,4034,-391740
20,28/08/2020,12.55 (-1.18 %),1935,5608100,2898,1440,6712200,4661,-1104100
1,27/08/2020,12.7 (3.25 %),2684,17727220,6605,2484,9509900,3828,8217320
2,26/08/2020,12.3 (0.41 %),1861,8798150,4728,1138,8752220,7691,45930
3,25/08/2020,12.25 (-1.21 %),1640,5854690,3570,1364,7741000,5675,-1886310
4,24/08/2020,12.4 (1.22 %),1541,10740990,6970,1725,10701520,6204,39470
5,21/08/2020,12.25 (1.24 %),1860,7722270,4152,1196,6983330,5839,738940
6,20/08/2020,12.1 (-0.82 %),1688,7857150,4655,1327,8748210,6592,-891060
7,19/08/2020,12.2 (-0.81 %),1330,5983810,4499,1072,6972750,6504,-988940
8,18/08/2020,12.3 (-0.81 %),988,6220150,6296,1132,6383740,5639,-163590
9,17/08/2020,12.4 (1.22 %),1430,9207770,6439,1291,6816710,5280,2391060
10,14/08/2020,12.25 (2.51 %),2305,13141770,5701,2035,11438430,5621,1703340
11,13/08/2020,11.95 (-0.42 %),1225,6130540,5005,1030,6124120,5946,6420
12,12/08/2020,12 (4.35 %),1506,10093410,6702,1745,7354900,4215,2738510
13,11/08/2020,11.5 (-0.43 %),621,1815250,2923,459,1608090,3503,207160
14,10/08/2020,11.55 (1.32 %),832,2813660,3382,658,2345020,3564,468640
15,07/08/2020,11.4 (-0.87 %),700,1847110,2639,458,1781180,3889,65930
16,06/08/2020,11.5 (-0.43 %),788,2499860,3172,575,2147800,3735,352060
17,05/08/2020,11.55 (1.32 %),901,3446200,3825,779,2642580,3392,803620
18,04/08/2020,11.4 (1.79 %),662,1916760,2895,646,2438450,3775,-521690
19,03/08/2020,11.2 (2.75 %),725,2428570,3350,686,2377910,3466,50660
20,31/07/2020,10.9 (-1.80 %),730,1667520,2284,458,1599240,3492,68280
1,30/07/2020,11.1 (0.91 %),540,1895070,3509,522,1796820,3442,98250
2,29/07/2020,11 (-4.35 %),1364,3553820,2605,695,4051310,5829,-497490
3,28/07/2020,11.5 (4.07 %),1058,4123520,3897,693,3045410,4395,1078110
4,27/07/2020,11.05 (-6.75 %),1142,2960350,2592,900,5493000,6103,-2532650
5,24/07/2020,11.85 (-5.20 %),1439,5177350,3598,1101,5667950,5148,-490600
6,23/07/2020,12.5 (0.40 %),1009,3844380,3810,585,2624670,4487,1219710
7,22/07/2020,12.45 (-2.35 %),947,3302380,3487,861,4032250,4683,-729870
8,21/07/2020,12.75 (-0.39 %),696,2749200,3950,744,3099750,4166,-350550
9,20/07/2020,12.8 (-0.39 %),0,0,,0,0,,0
10,17/07/2020,12.85 (3.21 %),1549,12800630,8264,2526,8714320,3450,4086310
11,16/07/2020,12.45 (0.40 %),830,2431970,2930,686,3167100,4617,-735130
12,15/07/2020,12.4 (-0.40 %),740,2010350,2717,622,2949170,4741,-938820
13,14/07/2020,12.45 (0.00 %),669,1831060,2737,489,1939950,3967,-108890
14,13/07/2020,12.45 (-0.40 %),737,2223490,3017,616,2764980,4489,-541490
15,10/07/2020,12.5 (-1.96 %),779,2265380,2908,788,3265940,4145,-1000560
16,09/07/2020,12.75 (3.24 %),0,0,,0,0,,0
17,08/07/2020,12.35 (0.00 %),619,1755760,2836,562,1922350,3421,-166590
18,07/07/2020,12.35 (-0.40 %),797,2530390,3175,795,3156290,3970,-625900
19,06/07/2020,12.4 (1.22 %),790,2715730,3438,725,2356860,3251,358870
20,03/07/2020,12.25 (0.41 %),1003,3015410,3006,848,2409640,2842,605770
1,02/07/2020,12.2 (-1.21 %),1056,2488350,2356,863,2661930,3085,-173580
2,01/07/2020,12.35 (2.49 %),920,2690150,2924,788,2002210,2541,687940
3,30/06/2020,12.05 (-2.43 %),1434,4349720,3033,878,3981410,4535,368310
4,29/06/2020,12.35 (-3.52 %),1154,3315820,2873,802,3230800,4028,85020
5,26/06/2020,12.8 (-2.29 %),928,2293990,2472,744,3915860,5263,-1621870
6,25/06/2020,13.1 (0.38 %),801,2879360,3595,613,3037960,4956,-158600
7,24/06/2020,13.05 (-1.14 %),1061,4479400,4222,1602,6254130,3904,-1774730
8,23/06/2020,13.2 (1.15 %),1136,4948400,4356,1374,6170810,4491,-1222410
9,22/06/2020,13.05 (1.16 %),965,4373000,4532,1137,4510760,3967,-137760
10,19/06/2020,12.9 (1.57 %),757,2636580,3483,804,2728550,3394,-91970
11,18/06/2020,12.7 (0.00 %),631,2212910,3507,689,2188940,3177,23970
12,17/06/2020,12.7 (0.79 %),825,3015000,3655,806,2774020,3442,240980
13,16/06/2020,12.6 (3.70 %),978,4074500,4166,926,2789530,3012,1284970
14,15/06/2020,12.15 (-4.71 %),1786,5716510,3201,1059,5896990,5568,-180480
15,12/06/2020,12.75 (-1.16 %),1849,5845750,3162,1255,5091970,4057,753780
16,11/06/2020,12.9 (-6.18 %),1822,7118260,3907,2031,8953970,4409,-1835710
17,10/06/2020,13.75 (1.85 %),2103,6898120,3280,1423,5749360,4040,1148760
18,09/06/2020,13.5 (-2.53 %),2556,6934570,2713,1608,7064660,4393,-130090
19,08/06/2020,13.85 (0.73 %),0,0,,0,0,,0
20,05/06/2020,13.75 (2.23 %),5199,38101910,7329,6028,22321170,3703,15780740
1,04/06/2020,13.45 (6.75 %),3036,21737730,7160,2815,9340910,3318,12396820
2,03/06/2020,12.6 (0.40 %),993,3368380,3392,875,3068330,3507,300050
3,02/06/2020,12.55 (-0.79 %),1082,2828940,2615,1022,3422470,3349,-593530
4,01/06/2020,12.65 (1.61 %),958,4096220,4276,1082,3771160,3485,325060
5,29/05/2020,12.45 (-0.80 %),1432,4176610,2917,966,4566610,4727,-390000
6,28/05/2020,12.55 (0.40 %),971,3589790,3697,1025,4063110,3964,-473320
7,27/05/2020,12.5 (-3.85 %),1538,4445850,2891,1591,6651560,4181,-2205710
8,26/05/2020,13 (4.00 %),2370,9503740,4010,2415,9379110,3884,124630
9,25/05/2020,12.5 (1.21 %),1161,3886490,3348,1218,4632370,3803,-745880
10,22/05/2020,12.35 (-1.59 %),835,2923460,3501,1115,4262560,3823,-1339100
11,21/05/2020,12.55 (0.00 %),884,3100040,3507,1500,5188170,3459,-2088130
12,20/05/2020,12.55 (2.03 %),1321,5324010,4030,1598,6448620,4035,-1124610
13,19/05/2020,12.3 (-0.40 %),1465,3592530,2452,1278,5564110,4354,-1971580
14,18/05/2020,12.35 (0.41 %),948,2617790,2761,851,3039110,3571,-421320
15,15/05/2020,12.3 (-1.20 %),1195,2974590,2489,1221,4830910,3957,-1856320
16,14/05/2020,12.45 (-0.80 %),1030,3318380,3222,1120,4539690,4053,-1221310
17,13/05/2020,12.55 (-1.18 %),1433,4455320,3109,1408,5207220,3698,-751900
18,12/05/2020,12.7 (3.67 %),1883,7571630,4021,1665,5735430,3445,1836200
19,11/05/2020,12.25 (1.66 %),0,0,,0,0,,0
20,08/05/2020,12.05 (-0.82 %),1673,6388060,3818,1447,6450550,4458,-62490
1,07/05/2020,12.15 (1.67 %),1077,3447110,3201,1025,3498090,3413,-50980
2,06/05/2020,11.95 (-1.24 %),1304,4999890,3834,771,3548930,4603,1450960
3,05/05/2020,12.1 (3.86 %),1312,4182340,3188,839,2714870,3236,1467470
4,04/05/2020,11.65 (-5.67 %),2266,5419280,2392,1102,5427630,4925,-8350
5,29/04/2020,12.35 (-0.80 %),1666,6097970,3660,1344,7087110,5273,-989140
6,28/04/2020,12.45 (-1.97 %),1485,6445520,4340,1135,4959940,4370,1485580
7,27/04/2020,12.7 (-0.78 %),1350,5244860,3885,1936,7455130,3851,-2210270
8,24/04/2020,12.8 (2.81 %),2180,9513450,4364,2467,8580710,3478,932740
9,23/04/2020,12.45 (4.18 %),1608,7729220,4807,1817,6518730,3588,1210490
10,22/04/2020,11.95 (4.37 %),1743,5222250,2996,989,4337930,4386,884320
11,21/04/2020,11.45 (-6.15 %),2210,5455030,2468,1380,7185740,5207,-1730710
12,20/04/2020,12.2 (2.95 %),2074,6072360,2928,1639,6293590,3840,-221230
13,17/04/2020,11.85 (-0.42 %),1133,2845410,2511,1363,4607790,3381,-1762380
14,16/04/2020,11.9 (3.03 %),1829,7124520,3895,1649,7304000,4429,-179480
15,15/04/2020,11.55 (6.94 %),1709,7896100,4620,1581,5686590,3597,2209510
16,14/04/2020,10.8 (1.41 %),968,2727590,2818,758,2888850,3811,-161260
17,13/04/2020,10.65 (0.00 %),1059,3139530,2965,847,3563500,4207,-423970
18,10/04/2020,10.65 (-2.29 %),910,2123410,2333,825,3792640,4597,-1669230
19,09/04/2020,10.9 (1.40 %),1149,4136340,3600,1236,4975770,4026,-839430
20,08/04/2020,10.75 (0.94 %),1078,3247750,3013,696,3055180,4390,192570
1,07/04/2020,10.65 (-1.39 %),1012,2450690,2422,889,3698460,4160,-1247770
2,06/04/2020,10.8 (4.85 %),936,4385520,4685,979,3384200,3457,1001320
3,03/04/2020,10.3 (3.10 %),1149,4002600,3484,951,3924110,4126,78490
4,01/04/2020,9.99 (6.39 %),676,2000180,2959,518,1618680,3125,381500
5,31/03/2020,9.39 (-3.20 %),1019,3314700,3253,628,3049340,4856,265360
6,30/03/2020,9.7 (-4.90 %),917,2610070,2846,534,2250030,4214,360040
7,27/03/2020,10.2 (-1.45 %),761,2786240,3661,608,3664080,6026,-877840
8,26/03/2020,10.35 (-2.36 %),873,3716070,4257,917,3895520,4248,-179450
9,25/03/2020,10.6 (4.95 %),686,3885690,5664,734,3174660,4325,711030
10,24/03/2020,10.1 (2.43 %),828,7014370,8471,773,3331480,4310,3682890
11,23/03/2020,9.86 (-6.98 %),937,5153600,5500,921,5322500,5779,-168900
12,20/03/2020,10.6 (0.47 %),581,1743610,3001,511,1866290,3652,-122680
13,19/03/2020,10.55 (-4.09 %),860,1948140,2265,560,1995820,3564,-47680
14,18/03/2020,11 (-1.35 %),703,2348750,3341,847,3382770,3994,-1034020
15,17/03/2020,11.15 (3.24 %),1226,3412140,2783,1042,3592510,3448,-180370
16,16/03/2020,10.8 (6.93 %),1266,4648810,3672,501,1590020,3174,3058790
17,13/03/2020,10.1 (0.50 %),1188,5268350,4435,927,3612520,3897,1655830
18,12/03/2020,10.05 (-6.94 %),1035,3225150,3116,771,4287820,5561,-1062670
19,11/03/2020,0 (0.00 %),1109,2847610,2568,663,3570480,5385,-722870
20,10/03/2020,11.35 (-1.30 %),1405,4116360,2930,700,3447810,4925,668550
1,09/03/2020,11.5 (-6.88 %),1094,3322930,3037,874,7517460,8601,-4194530
2,06/03/2020,12.35 (-1.98 %),1049,2865270,2731,502,3112570,6200,-247300
3,05/03/2020,12.6 (-0.40 %),616,2132310,3462,888,3878310,4367,-1746000
4,04/03/2020,12.65 (0.00 %),757,2437770,3220,632,2906330,4599,-468560
5,03/03/2020,12.65 (2.02 %),829,3707170,4472,885,4055600,4583,-348430
6,02/03/2020,12.4 (0.40 %),0,0,,0,0,,0
7,28/02/2020,12.35 (-2.76 %),1210,3237210,2675,708,4376020,6181,-1138810
8,27/02/2020,12.7 (0.79 %),746,2938470,3939,719,2737930,3808,200540
9,26/02/2020,12.6 (0.00 %),976,3635050,3724,650,3518950,5414,116100
10,25/02/2020,12.6 (1.61 %),1614,6309560,3909,1000,5198180,5198,1111380
11,24/02/2020,12.4 (-6.77 %),0,0,,0,0,,0
12,21/02/2020,13.3 (1.14 %),0,0,,0,0,,0
13,20/02/2020,13.15 (6.91 %),2294,10139710,4420,1828,6193190,3388,3946520
14,19/02/2020,12.3 (0.82 %),494,1778550,3600,595,2153030,3619,-374480
15,18/02/2020,12.2 (-1.21 %),574,1828910,3186,711,3367760,4737,-1538850
16,17/02/2020,12.35 (0.41 %),648,2175180,3357,775,3040430,3923,-865250
17,14/02/2020,12.3 (0.00 %),756,2399250,3174,721,3180480,4411,-781230
18,13/02/2020,12.3 (-0.40 %),741,2078360,2805,762,3273570,4296,-1195210
19,12/02/2020,12.35 (0.82 %),1118,4161570,3722,1051,4703940,4476,-542370
20,11/02/2020,12.25 (1.24 %),881,2837170,3220,737,3277040,4446,-439870
1,10/02/2020,12.1 (-1.22 %),971,3224850,3321,768,3044500,3964,180350
2,07/02/2020,12.25 (2.51 %),1259,4929050,3915,1256,5098220,4059,-169170
3,06/02/2020,11.95 (6.70 %),1702,7752250,4555,1051,4083770,3886,3668480
4,05/02/2020,11.2 (1.82 %),883,2574430,2916,738,2420780,3280,153650
5,04/02/2020,11 (2.80 %),1318,4528470,3436,844,3646230,4320,882240
6,03/02/2020,10.7 (-6.96 %),1439,4228540,2939,964,6625170,6873,-2396630
7,31/01/2020,11.5 (-4.96 %),1135,3076930,2711,725,4148760,5722,-1071830
8,30/01/2020,12.1 (-3.97 %),1136,2521370,2220,594,3463760,5831,-942390
9,22/01/2020,12.6 (0.40 %),659,1875870,2847,485,2340280,4825,-464410
10,21/01/2020,12.55 (0.80 %),543,1923980,3543,567,2202380,3884,-278400
11,20/01/2020,12.45 (-0.40 %),505,1404160,2781,643,2014010,3132,-609850
12,17/01/2020,12.5 (0.81 %),649,2441210,3761,986,3079660,3123,-638450
13,16/01/2020,12.4 (4.20 %),982,4325660,4405,1225,3866070,3156,459590
14,15/01/2020,11.9 (0.00 %),716,2097320,2929,690,2974250,4311,-876930
15,14/01/2020,11.9 (-0.83 %),771,1779730,2308,668,2936450,4396,-1156720
16,13/01/2020,12 (-0.83 %),657,1503610,2289,675,2817230,4174,-1313620
17,10/01/2020,12.1 (0.41 %),611,1850470,3029,717,2733100,3812,-882630
18,09/01/2020,12.05 (0.42 %),714,1914310,2681,771,3733490,4842,-1819180
19,08/01/2020,12 (-3.23 %),1532,4292420,2802,1054,5523660,5241,-1231240
20,07/01/2020,12.4 (0.81 %),827,2632790,3184,846,3168000,3745,-535210
1,06/01/2020,12.3 (-3.15 %),1235,2362700,1913,753,3378860,4487,-1016160
2,03/01/2020,12.7 (-0.39 %),928,1871700,2017,754,2740140,3634,-868440
3,02/01/2020,12.75 (0.39 %),682,1839800,2698,713,2215620,3107,-375820
4,31/12/2019,12.7 (0.79 %),675,2046170,3031,725,2423540,3343,-377370
5,30/12/2019,12.6 (-2.33 %),939,2465990,2626,802,3462140,4317,-996150
6,27/12/2019,12.9 (1.18 %),939,3106970,3309,774,2580380,3334,526590
7,26/12/2019,12.75 (-1.54 %),930,2353540,2531,884,3152550,3566,-799010
8,25/12/2019,12.95 (4.44 %),1448,4627420,3196,1005,3659600,3641,967820
9,24/12/2019,12.4 (-1.98 %),1529,4073670,2664,1040,4507790,4334,-434120
10,23/12/2019,12.65 (-5.60 %),0,0,,0,0,,0
11,20/12/2019,13.4 (-1.11 %),1030,2357180,2289,687,3587840,5222,-1230660
12,19/12/2019,13.55 (-2.17 %),1522,3081800,2025,775,5560110,7174,-2478310
13,18/12/2019,13.85 (-0.36 %),766,1693850,2211,574,2493650,4344,-799800
14,17/12/2019,13.9 (-1.42 %),942,2093590,2222,559,3882710,6946,-1789120
15,16/12/2019,14.1 (0.00 %),601,1496280,2490,595,3031300,5095,-1535020
16,13/12/2019,14.1 (0.36 %),843,2529470,3001,806,3485500,4324,-956030
17,12/12/2019,14.05 (0.36 %),733,2040720,2784,639,2268920,3551,-228200
18,11/12/2019,14 (0.72 %),661,1658570,2509,448,2350630,5247,-692060
19,10/12/2019,13.9 (-1.77 %),998,2135390,2140,608,4521710,7437,-2386320
20,09/12/2019,14.15 (-0.35 %),732,1680010,2295,644,2634150,4090,-954140
1,06/12/2019,14.2 (1.43 %),946,3604380,3810,830,3906050,4706,-301670
2,05/12/2019,14 (0.72 %),803,2381140,2965,597,3210700,5378,-829560
3,04/12/2019,13.9 (0.36 %),0,0,,0,0,,0
4,03/12/2019,13.85 (0.00 %),991,2777700,2803,896,3670570,4097,-892870
5,02/12/2019,13.85 (-1.77 %),868,1974750,2275,640,3086210,4822,-1111460
6,29/11/2019,14.1 (0.00 %),844,1964350,2327,564,2212080,3922,-247730
7,28/11/2019,14.1 (-0.70 %),916,2027870,2214,590,3717940,6302,-1690070
8,27/11/2019,14.2 (0.00 %),966,2319120,2401,628,3249230,5174,-930110
9,26/11/2019,14.2 (0.71 %),1148,3435230,2992,642,3004250,4680,430980
10,25/11/2019,14.1 (-1.74 %),1182,2694230,2279,736,3404110,4625,-709880
11,22/11/2019,14.35 (-3.04 %),1604,3557980,2218,874,5280110,6041,-1722130
12,21/11/2019,14.8 (-0.67 %),1263,2945400,2332,603,3522810,5842,-577410
13,20/11/2019,14.9 (-0.67 %),1003,2467430,2460,531,3681080,6932,-1213650
14,19/11/2019,15 (0.67 %),1304,4070210,3121,591,4175830,7066,-105620
15,18/11/2019,14.9 (-1.00 %),1136,2832830,2494,723,3723630,5150,-890800
16,15/11/2019,15.05 (-1.31 %),1309,3546690,2709,767,5609880,7314,-2063190
17,14/11/2019,15.25 (-1.61 %),1286,4253500,3308,881,5896410,6693,-1642910
18,13/11/2019,15.5 (-0.96 %),1330,4228130,3179,810,5318770,6566,-1090640
19,12/11/2019,15.65 (1.29 %),1744,7583060,4348,1013,7742280,7643,-159220
20,11/11/2019,15.45 (-2.52 %),1714,5477210,3196,955,7308030,7652,-1830820
1,08/11/2019,15.85 (0.32 %),1259,5751490,4568,1119,6781790,6061,-1030300
2,07/11/2019,15.8 (0.64 %),1233,5202030,4219,1093,6394220,5850,-1192190
3,06/11/2019,15.7 (-1.26 %),1214,4135680,3407,1201,6980770,5812,-2845090
4,05/11/2019,15.9 (1.60 %),1751,9116680,5207,1583,10483170,6622,-1366490
5,04/11/2019,15.65 (-0.63 %),1071,4819840,4500,1368,6945390,5077,-2125550
6,01/11/2019,15.75 (3.62 %),2340,11910690,5090,2174,8969690,4126,2941000
7,31/10/2019,15.2 (0.33 %),851,3722970,4375,1093,5010210,4584,-1287240
8,30/10/2019,15.15 (0.33 %),669,2876400,4300,913,4173780,4572,-1297380
9,29/10/2019,15.1 (-0.33 %),740,2750230,3717,705,3774860,5354,-1024630
10,28/10/2019,15.15 (-0.33 %),680,3212330,4724,852,4270680,5013,-1058350
11,25/10/2019,15.2 (-0.65 %),645,2793570,4331,707,5248100,7423,-2454530
12,24/10/2019,15.3 (-0.33 %),745,4283020,5749,1101,7740900,7031,-3457880
13,23/10/2019,15.35 (1.66 %),1069,4796610,4487,1456,7954960,5464,-3158350
14,22/10/2019,15.1 (0.67 %),973,4023800,4135,855,4301810,5031,-278010
15,21/10/2019,15 (-0.99 %),1019,3846360,3775,845,4953090,5862,-1106730
16,18/10/2019,15.15 (-1.30 %),737,3804110,5162,772,4535150,5875,-731040
17,17/10/2019,15.35 (0.00 %),845,3524110,4171,1001,4345420,4341,-821310
18,16/10/2019,15.35 (1.99 %),1283,5904480,4602,2026,6587240,3251,-682760
19,15/10/2019,15.05 (-0.99 %),749,3843670,5132,772,3639080,4714,204590
20,14/10/2019,15.2 (1.67 %),1059,6600040,6232,978,5116340,5231,1483700
1,11/10/2019,14.95 (0.34 %),623,2146700,3446,714,2897340,4058,-750640
2,10/10/2019,14.9 (0.68 %),721,2159970,2996,736,3392270,4609,-1232300
3,09/10/2019,14.8 (0.00 %),639,1896260,2968,658,3640040,5532,-1743780
4,08/10/2019,14.8 (-1.00 %),983,2145020,2182,755,4252620,5633,-2107600
5,07/10/2019,14.95 (-1.64 %),747,1724620,2309,826,4784430,5792,-3059810
6,04/10/2019,15.2 (0.66 %),805,2453260,3048,736,4022810,5466,-1569550
7,03/10/2019,15.1 (-0.33 %),951,3313840,3485,807,5433730,6733,-2119890
8,02/10/2019,15.15 (-0.66 %),1279,3346960,2617,1015,4440880,4375,-1093920
9,01/10/2019,15.25 (-0.65 %),994,3242340,3262,703,2799340,3982,443000
10,30/09/2019,15.35 (1.32 %),1046,4610380,4408,1064,3888010,3654,722370
11,27/09/2019,15.15 (-3.19 %),2722,5572240,2047,1575,8574080,5444,-3001840
12,26/09/2019,15.65 (-0.32 %),988,2781950,2816,1081,3483490,3222,-701540
13,25/09/2019,15.7 (-0.63 %),1020,2762660,2708,671,3652930,5444,-890270
14,24/09/2019,15.8 (-0.63 %),766,2454730,3205,618,2931810,4744,-477080
15,23/09/2019,15.9 (-0.62 %),649,1819440,2803,780,3719280,4768,-1899840
16,20/09/2019,16 (0.00 %),843,3358540,3984,942,7617430,8086,-4258890
17,19/09/2019,16 (0.31 %),812,2362050,2909,638,2658790,4167,-296740
18,18/09/2019,15.95 (-0.31 %),805,4761040,5914,706,2991730,4238,1769310
19,17/09/2019,16 (0.31 %),1043,3657150,3506,772,4218000,5464,-560850
20,16/09/2019,15.95 (-2.45 %),1443,3391520,2350,726,7801110,10745,-4409590
1,13/09/2019,16.35 (0.00 %),756,3983480,5269,879,4141070,4711,-157590
2,12/09/2019,16.35 (2.19 %),966,4950880,5125,1264,4111270,3253,839610
3,11/09/2019,16 (0.31 %),658,1656290,2517,601,2232180,3714,-575890
4,10/09/2019,15.95 (0.00 %),1028,3214870,3127,946,4809420,5084,-1594550
5,09/09/2019,15.95 (0.00 %),608,1570740,2583,650,2079990,3200,-509250
6,06/09/2019,15.95 (-0.31 %),614,1780390,2900,749,3132100,4182,-1351710
7,05/09/2019,16 (0.63 %),911,2660930,2921,889,3050360,3431,-389430
8,04/09/2019,15.9 (-0.31 %),1211,2420880,1999,591,2533750,4287,-112870
9,03/09/2019,15.95 (-2.74 %),947,2048090,2163,702,2945860,4196,-897770
10,30/08/2019,16.4 (3.80 %),1641,5322660,3244,1180,4639970,3932,682690
11,29/08/2019,15.8 (-1.56 %),1239,3252460,2625,864,4038680,4674,-786220
12,28/08/2019,16.05 (-1.23 %),1238,2761140,2230,919,4255790,4631,-1494650
13,27/08/2019,16.25 (-1.52 %),1668,4057610,2433,1004,5184790,5164,-1127180
14,26/08/2019,16.5 (-2.65 %),1861,3647220,1960,942,5348270,5678,-1701050
15,23/08/2019,16.95 (0.30 %),791,1967590,2487,724,2805260,3875,-837670
16,22/08/2019,16.9 (0.00 %),884,2536840,2870,880,3745240,4256,-1208400
17,21/08/2019,16.9 (0.30 %),1370,3984130,2908,991,4585010,4627,-600880
18,20/08/2019,16.85 (-0.59 %),1030,2697210,2619,875,4043890,4622,-1346680
19,19/08/2019,16.95 (-0.59 %),875,1604020,1833,710,3350980,4720,-1746960
20,16/08/2019,17.05 (-0.87 %),1136,2464850,2170,789,3952070,5009,-1487220
1,15/08/2019,17.2 (0.00 %),1358,2968020,2186,682,3797750,5569,-829730
2,14/08/2019,17.2 (-1.15 %),1257,2870250,2283,758,3753340,4952,-883090
3,13/08/2019,17.4 (0.00 %),1002,2869020,2863,765,3469280,4535,-600260
4,12/08/2019,17.4 (-1.14 %),1027,2749310,2677,757,4358160,5757,-1608850
5,09/08/2019,17.6 (0.57 %),1427,4573960,3205,928,4899410,5280,-325450
6,08/08/2019,17.5 (0.29 %),1686,5555720,3295,810,4747020,5861,808700
7,07/08/2019,17.45 (0.29 %),1491,4358210,2923,894,4448890,4976,-90680
8,06/08/2019,17.4 (-0.85 %),2709,9200490,3396,1448,8798890,6077,401600
9,05/08/2019,17.55 (-1.68 %),1965,5538390,2819,1173,9098390,7757,-3560000
10,02/08/2019,17.85 (-0.56 %),2305,6417110,2784,852,8044460,9442,-1627350
11,01/08/2019,17.95 (0.28 %),2261,5997470,2653,903,4649570,5149,1347900
12,31/07/2019,17.9 (-1.92 %),2687,7033230,2618,1334,7259530,5442,-226300
13,30/07/2019,18.25 (-0.54 %),2264,8281490,3658,1314,8360500,6363,-79010
14,29/07/2019,18.35 (-1.87 %),2134,5087320,2384,928,5961730,6424,-874410
15,26/07/2019,18.7 (-1.32 %),1575,4706500,2988,1322,6676920,5051,-1970420
16,25/07/2019,18.95 (1.34 %),2156,7198930,3339,1388,6938980,4999,259950
17,24/07/2019,18.7 (0.00 %),1199,3664160,3056,927,4331400,4672,-667240
18,23/07/2019,18.7 (0.54 %),1966,6735640,3426,1192,6496790,5450,238850
19,22/07/2019,18.6 (-1.06 %),1724,4950540,2872,968,5867850,6062,-917310
20,19/07/2019,18.8 (1.08 %),1550,5412140,3492,880,4795790,5450,616350
1,18/07/2019,18.6 (0.54 %),1804,5601450,3105,996,5727870,5751,-126420
2,17/07/2019,18.5 (-1.86 %),2309,7545720,3268,1324,9057150,6841,-1511430
3,16/07/2019,18.85 (0.00 %),1189,5434040,4570,1226,5910680,4821,-476640
4,15/07/2019,18.85 (0.27 %),1131,3862810,3415,766,3737360,4879,125450
5,12/07/2019,18.8 (0.53 %),1458,5545970,3804,1045,5853620,5602,-307650
6,11/07/2019,18.7 (-1.06 %),2483,7834480,3155,1384,8028190,5801,-193710
7,10/07/2019,18.9 (-1.82 %),1714,7678710,4480,1969,10237730,5199,-2559020
8,09/07/2019,19.25 (0.52 %),1657,7532980,4546,1621,8154320,5030,-621340
9,08/07/2019,19.15 (0.52 %),1549,6761920,4365,1738,8776440,5050,-2014520
10,05/07/2019,19.05 (2.14 %),2203,10112930,4591,1997,8478010,4245,1634920
11,04/07/2019,18.65 (0.00 %),0,0,,0,0,,0
12,03/07/2019,18.65 (0.27 %),1540,8631860,5605,1519,6406010,4217,2225850
13,02/07/2019,18.6 (-0.80 %),1540,8631860,5605,1519,6406010,4217,2225850
14,01/07/2019,18.75 (2.18 %),1323,7889570,5963,2152,8324030,3868,-434460
15,28/06/2019,18.35 (1.94 %),0,0,,0,0,,0
16,27/06/2019,18 (-1.91 %),1320,4544790,3443,1048,7163510,6835,-2618720
17,26/06/2019,18.35 (0.00 %),995,3116470,3132,941,4292870,4562,-1176400
18,25/06/2019,18.35 (-0.27 %),1091,3065010,2809,886,4473480,5049,-1408470
19,24/06/2019,18.4 (0.00 %),1197,3992970,3336,1317,5923580,4498,-1930610
20,21/06/2019,18.4 (-0.81 %),1362,5377230,3948,1258,6593570,5241,-1216340
1,20/06/2019,18.55 (1.09 %),1540,8631860,5605,1519,6406010,4217,2225850
2,19/06/2019,18.35 (-1.34 %),1634,6599800,4039,1749,8064420,4611,-1464620
3,18/06/2019,18.6 (3.05 %),2107,11276850,5352,2366,9829500,4154,1447350
4,17/06/2019,18.05 (-0.28 %),1207,3838980,3181,1146,5179940,4520,-1340960
5,14/06/2019,18.1 (1.40 %),2302,9170460,3984,2482,11146940,4491,-1976480
6,13/06/2019,17.85 (1.71 %),1444,5658680,3919,1033,4897710,4741,760970
7,12/06/2019,17.55 (-1.40 %),1037,3631590,3502,828,4068770,4914,-437180
8,11/06/2019,17.8 (-0.84 %),1213,4912750,4050,1511,7755520,5133,-2842770
9,10/06/2019,17.95 (1.13 %),1271,4955520,3899,1543,6293860,4079,-1338340
10,07/06/2019,17.75 (2.60 %),1150,5032820,4376,1098,3961620,3608,1071200
11,06/06/2019,17.3 (-0.57 %),1118,3719450,3327,783,4116890,5258,-397440
12,05/06/2019,17.4 (0.29 %),925,3316710,3586,716,3671200,5127,-354490
13,04/06/2019,17.35 (0.29 %),1369,4775990,3489,848,4295510,5065,480480
14,03/06/2019,17.3 (-2.54 %),0,0,,0,0,,0
15,31/05/2019,17.75 (-2.20 %),1544,8465080,5483,1458,6914580,4743,1550500
16,30/05/2019,18.15 (-1.09 %),1629,6728540,4130,1520,6853120,4509,-124580
17,29/05/2019,18.35 (3.67 %),3092,13824190,4471,2427,12170640,5015,1653550
18,28/05/2019,17.7 (0.57 %),1308,4258130,3255,1335,5496770,4117,-1238640
19,27/05/2019,17.6 (1.15 %),1102,3840850,3485,1026,3754250,3659,86600
20,24/05/2019,17.4 (-1.69 %),1405,4613630,3284,1096,4654100,4246,-40470
1,23/05/2019,17.7 (2.31 %),1908,6990950,3664,1223,6310370,5160,680580
2,22/05/2019,17.3 (-1.42 %),1551,4627880,2984,975,5596380,5740,-968500
3,21/05/2019,17.55 (-0.85 %),1528,4875600,3191,1335,7641860,5724,-2766260
4,20/05/2019,17.7 (0.85 %),1473,6369050,4324,1303,5433650,4170,935400
5,17/05/2019,17.55 (0.57 %),1441,4491810,3117,1190,4952750,4162,-460940
6,16/05/2019,17.45 (-0.85 %),1049,3126570,2981,1175,4849840,4128,-1723270
7,15/05/2019,17.6 (0.86 %),2046,8948430,4374,1933,11695490,6050,-2747060
8,14/05/2019,17.45 (1.45 %),2064,5920150,2868,915,4484180,4901,1435970
9,13/05/2019,17.2 (0.00 %),1340,3592280,2681,905,4218890,4662,-626610
10,10/05/2019,17.2 (1.78 %),2040,7201480,3530,1097,7155860,6523,45620
11,09/05/2019,16.9 (-2.31 %),1617,3397380,2101,805,4468450,5551,-1071070
12,08/05/2019,17.3 (-0.86 %),1613,3875380,2403,716,3167140,4423,708240
13,07/05/2019,17.45 (2.05 %),1582,5572960,3523,974,5104620,5241,468340
14,06/05/2019,17.1 (-3.66 %),2746,6641650,2419,950,6896630,7260,-254980
15,03/05/2019,17.75 (-2.47 %),2927,8212220,2806,954,8100750,8491,111470
16,02/05/2019,18.2 (-1.62 %),1512,4715040,3118,1060,5539900,5226,-824860
17,26/04/2019,18.5 (3.35 %),1729,7728310,4470,1664,6664970,4005,1063340
18,25/04/2019,17.9 (-1.10 %),1071,3471320,3241,923,4194710,4545,-723390
19,24/04/2019,18.1 (2.84 %),1928,7405900,3841,1330,5902470,4438,1503430
20,23/04/2019,17.6 (1.15 %),1839,5291440,2877,876,5275420,6022,16020
1,22/04/2019,17.4 (-3.60 %),2268,5933060,2616,1090,5945480,5455,-12420
2,19/04/2019,18.05 (1.40 %),1886,8052720,4270,1070,5535440,5173,2517280
3,18/04/2019,17.8 (-1.11 %),3425,11752800,3431,1815,11603960,6393,148840
4,17/04/2019,18 (-6.98 %),2955,12708770,4301,1976,16518060,8359,-3809290
5,16/04/2019,19.35 (0.00 %),0,0,,0,0,,0
6,12/04/2019,19.35 (2.38 %),2708,14448130,5335,2153,11002210,5110,3445920
7,11/04/2019,18.9 (2.16 %),3049,16226670,5322,1646,11683430,7098,4543240
8,10/04/2019,18.5 (0.00 %),2618,13430600,5130,1788,11662160,6522,1768440
9,09/04/2019,18.5 (-2.12 %),3167,11398860,3599,2478,14011880,5655,-2613020
10,08/04/2019,18.9 (6.78 %),3265,15771670,4831,2850,12491980,4383,3279690
11,05/04/2019,17.7 (2.02 %),1518,6983260,4600,1920,6827790,3556,155470
12,04/04/2019,17.35 (-0.29 %),1372,5582890,4069,1390,6465330,4651,-882440
13,03/04/2019,17.4 (1.16 %),1238,6269520,5064,1100,4546850,4134,1722670
14,02/04/2019,17.2 (-0.58 %),1376,5855620,4256,1652,6488050,3927,-632430
15,01/04/2019,17.3 (2.67 %),1474,7570420,5136,2522,8634420,3424,-1064000
16,29/03/2019,16.85 (0.30 %),1042,3956260,3797,1921,6475260,3371,-2519000
17,28/03/2019,16.8 (3.07 %),1847,7319930,3963,2199,8106210,3686,-786280
18,27/03/2019,16.3 (0.93 %),1160,4482080,3864,1089,4492030,4125,-9950
19,26/03/2019,16.15 (0.62 %),773,2323920,3006,685,2484560,3627,-160640
20,25/03/2019,16.05 (-1.53 %),902,2589690,2871,774,3094310,3998,-504620
1,22/03/2019,16.3 (1.24 %),1004,4615420,4597,1196,4423490,3699,191930
2,21/03/2019,16.1 (0.94 %),1213,6290380,5186,1355,6098990,4501,191390
3,20/03/2019,15.95 (-0.31 %),892,2894850,3245,641,2856580,4456,38270
4,19/03/2019,16 (-2.44 %),1225,3864490,3155,935,4889330,5229,-1024840
5,18/03/2019,16.4 (0.61 %),778,3239540,4164,978,3390870,3467,-151330
6,15/03/2019,16.3 (-0.91 %),832,3087430,3711,883,3424040,3878,-336610
7,14/03/2019,16.45 (1.54 %),1138,5126920,4505,1186,4777440,4028,349480
8,13/03/2019,16.2 (-1.52 %),1105,3313920,2999,1097,4168970,3800,-855050
9,12/03/2019,16.45 (0.61 %),828,4458140,5384,1157,4488330,3879,-30190
10,11/03/2019,16.35 (3.48 %),1107,4984500,4503,751,3856580,5135,1127920
11,08/03/2019,15.8 (-3.95 %),1678,4714870,2810,1032,6327430,6131,-1612560
12,07/03/2019,16.45 (-1.20 %),1409,5385510,3822,1713,6860640,4005,-1475130
13,06/03/2019,16.65 (0.30 %),1058,4256840,4023,1108,4841160,4369,-584320
14,05/03/2019,16.6 (0.91 %),1802,8384260,4653,2355,9672740,4107,-1288480
15,04/03/2019,16.45 (6.82 %),1777,7488260,4214,1720,4490100,2611,2998160
16,01/03/2019,15.4 (2.33 %),695,3281440,4721,614,2460350,4007,821090
17,28/02/2019,15.05 (-1.63 %),716,2254640,3149,798,3086820,3868,-832180
18,27/02/2019,15.3 (1.66 %),894,3864140,4322,1062,3642000,3429,222140
19,26/02/2019,15.05 (-0.99 %),721,1687470,2340,526,2126890,4044,-439420
20,25/02/2019,15.2 (-0.33 %),737,1944710,2639,585,2490550,4257,-545840
1,22/02/2019,15.25 (1.33 %),1013,2817800,2782,676,2875370,4254,-57570
2,21/02/2019,15.05 (0.33 %),608,1749620,2878,510,2204000,4322,-454380
3,20/02/2019,15 (0.00 %),914,3034580,3320,629,2752910,4377,281670
4,19/02/2019,15 (-2.91 %),1088,2505000,2302,758,3399680,4485,-894680
5,18/02/2019,15.45 (0.00 %),875,2343080,2678,675,3116500,4617,-773420
6,15/02/2019,15.45 (-0.32 %),828,2439190,2946,686,2726670,3975,-287480
7,14/02/2019,15.5 (-0.32 %),855,2327490,2722,944,3081060,3264,-753570
8,13/02/2019,15.55 (0.97 %),943,3721840,3947,981,3815980,3890,-94140
9,12/02/2019,15.4 (3.70 %),1185,4039550,3409,1164,4002540,3439,37010
10,11/02/2019,14.85 (1.02 %),761,2038810,2679,649,2271550,3500,-232740
11,01/02/2019,14.7 (1.38 %),617,2362430,3829,430,2390890,5560,-28460
12,31/01/2019,14.5 (1.40 %),1106,2904380,2626,668,3134590,4693,-230210
13,30/01/2019,14.3 (0.35 %),639,1862560,2915,421,2206270,5241,-343710
14,29/01/2019,14.25 (0.00 %),711,2149900,3024,472,2657610,5631,-507710
15,28/01/2019,14.25 (-0.70 %),724,1706100,2356,493,2392150,4852,-686050
16,25/01/2019,14.35 (-0.69 %),629,1776170,2824,508,2285940,4500,-509770
17,24/01/2019,14.45 (0.35 %),699,1960360,2805,460,2302990,5007,-342630
18,23/01/2019,14.4 (-0.69 %),668,1705500,2553,1374,2055530,1496,-350030
19,22/01/2019,14.5 (0.69 %),750,1831850,2442,588,2346260,3990,-514410
20,21/01/2019,14.4 (0.00 %),873,2697350,3090,566,2763350,4882,-66000
1,18/01/2019,14.4 (-1.37 %),591,1636600,2769,506,2173380,4295,-536780
2,17/01/2019,14.6 (-1.68 %),618,1731720,2802,652,2585080,3965,-853360
3,16/01/2019,14.85 (1.71 %),734,2673240,3642,874,3508700,4015,-835460
4,15/01/2019,14.6 (2.82 %),1108,3594470,3244,729,3035970,4165,558500
5,14/01/2019,14.2 (-1.05 %),599,1475890,2464,411,2159820,5255,-683930
6,11/01/2019,14.35 (-0.35 %),565,1666230,2949,395,2091920,5296,-425690
7,10/01/2019,14.4 (-1.03 %),504,1415930,2809,468,1766270,3774,-350340
8,09/01/2019,14.55 (2.46 %),886,2198680,2482,592,2164660,3657,34020
9,08/01/2019,14.2 (-1.39 %),537,1509800,2812,406,1757320,4328,-247520
10,07/01/2019,14.4 (1.05 %),528,1569350,2972,492,1978280,4021,-408930
11,04/01/2019,14.25 (0.00 %),959,2454180,2559,596,2709510,4546,-255330
12,03/01/2019,14.25 (-1.72 %),678,1964990,2898,500,2524990,5050,-560000
13,02/01/2019,14.5 (-1.36 %),427,1420770,3327,443,1904540,4299,-483770
14,28/12/2018,14.7 (-1.34 %),713,1807220,2535,567,2868440,5059,-1061220
15,27/12/2018,14.9 (2.76 %),562,3361800,5982,652,2641130,4051,720670
16,26/12/2018,14.5 (0.00 %),520,1881470,3618,573,2793650,4875,-912180
17,25/12/2018,14.5 (-2.03 %),1313,3881700,2956,665,4114240,6187,-232540
18,24/12/2018,14.8 (-2.31 %),939,2379400,2534,493,2920330,5924,-540930
19,21/12/2018,15.15 (-2.26 %),838,1831450,2186,419,1810810,4322,20640
20,20/12/2018,15.5 (1.64 %),715,2041030,2855,490,1970510,4021,70520
1,19/12/2018,15.25 (-2.87 %),774,2016870,2606,525,2648390,5045,-631520
2,18/12/2018,15.7 (-2.48 %),1221,3384410,2772,764,3545320,4640,-160910
3,17/12/2018,16.1 (-2.13 %),826,2417830,2927,625,2833860,4534,-416030
4,14/12/2018,16.45 (0.30 %),1073,4046420,3771,940,3624180,3856,422240
5,13/12/2018,16.4 (-0.61 %),1023,3141130,3071,944,3331620,3529,-190490
6,12/12/2018,16.5 (0.00 %),1102,3305960,3000,1169,4934050,4221,-1628090
7,11/12/2018,16.5 (0.61 %),1569,5585950,3560,1713,6851240,4000,-1265290
8,10/12/2018,16.4 (3.14 %),1587,5488960,3459,1233,4767500,3867,721460
9,07/12/2018,15.9 (0.32 %),1197,2971780,2483,751,3467220,4617,-495440
10,06/12/2018,15.85 (-1.86 %),1251,3333260,2664,959,3568820,3721,-235560
11,05/12/2018,16.15 (3.86 %),1409,5576540,3958,1370,4568270,3335,1008270
12,04/12/2018,15.55 (1.97 %),1303,5263560,4040,1164,4781070,4107,482490
13,03/12/2018,15.25 (2.69 %),1201,3105980,2586,636,3119650,4905,-13670
14,30/11/2018,14.85 (-0.67 %),717,2075240,2894,489,1950880,3990,124360
15,29/11/2018,14.95 (-2.92 %),889,2442640,2748,733,3730520,5089,-1287880
16,28/11/2018,15.4 (-0.96 %),949,2777570,2927,828,3186930,3849,-409360
17,27/11/2018,15.55 (0.32 %),1162,3907200,3362,1543,4871850,3157,-964650
18,26/11/2018,15.5 (2.65 %),1395,5061910,3629,1538,5656430,3678,-594520
19,23/11/2018,15.1 (1.00 %),886,3589740,4052,1015,4027930,3968,-438190
20,22/11/2018,14.95 (0.67 %),676,1926620,2850,929,3102160,3339,-1175540
1,21/11/2018,14.85 (0.34 %),1312,5314520,4051,1567,6955620,4439,-1641100
2,20/11/2018,14.8 (6.86 %),1413,7520130,5322,1385,5573090,4024,1947040
3,19/11/2018,13.85 (-1.07 %),615,1171260,1904,381,1935750,5081,-764490
4,16/11/2018,14 (1.82 %),653,2330530,3569,568,2271600,3999,58930
5,15/11/2018,13.75 (-2.48 %),830,1937590,2334,530,2126150,4012,-188560
6,14/11/2018,14.1 (-0.35 %),829,1866270,2251,551,1899090,3447,-32820
7,13/11/2018,14.15 (-3.08 %),921,2111290,2292,412,2079550,5047,31740
8,12/11/2018,14.6 (-0.68 %),494,1660000,3360,389,1690280,4345,-30280
9,09/11/2018,14.7 (-2.65 %),600,1340020,2233,556,1962590,3530,-622570
10,08/11/2018,15.1 (4.86 %),1457,4851870,3330,1316,3901540,2965,950330
11,07/11/2018,14.4 (0.00 %),282,1177960,4177,524,1542090,2943,-364130
12,06/11/2018,14.4 (1.05 %),366,1024530,2799,468,1181560,2525,-157030
13,05/11/2018,14.25 (0.71 %),405,1285190,3173,337,1223270,3630,61920
14,02/11/2018,14.15 (0.00 %),726,1867310,2572,403,1761400,4371,105910
15,01/11/2018,14.15 (-3.08 %),579,2014880,3480,549,2832660,5160,-817780
16,31/10/2018,14.6 (2.10 %),777,3169270,4079,539,3551400,6589,-382130
17,30/10/2018,14.3 (0.35 %),234,2144070,9163,853,2175990,2551,-31920
18,29/10/2018,14.25 (0.35 %),534,2073460,3883,590,2583090,4378,-509630
19,26/10/2018,14.2 (0.35 %),571,2180450,3819,812,3170820,3905,-990370
20,25/10/2018,14.15 (-2.08 %),790,3762450,4763,873,5154320,5904,-1391870
1,24/10/2018,14.45 (-0.34 %),685,1661680,2426,530,2336290,4408,-674610
2,23/10/2018,14.5 (-2.03 %),1033,2364810,2289,676,3260380,4823,-895570
3,22/10/2018,14.8 (0.34 %),887,2175300,2452,496,2296620,4630,-121320
4,19/10/2018,14.75 (-1.67 %),1371,2868680,2092,561,3258170,5808,-389490
5,18/10/2018,15 (-3.23 %),1012,2028710,2005,513,2454800,4785,-426090
6,17/10/2018,15.5 (0.65 %),825,2112240,2560,623,3007980,4828,-895740
7,16/10/2018,15.4 (-0.65 %),950,1977080,2081,461,2379810,5162,-402730
8,15/10/2018,15.5 (1.97 %),1171,2466010,2106,809,2103680,2600,362330
9,12/10/2018,15.2 (3.05 %),1829,3553560,1943,755,3020590,4001,532970
10,11/10/2018,14.75 (-6.94 %),1504,3826790,2544,929,4997180,5379,-1170390
11,10/10/2018,15.85 (-3.35 %),2316,4235620,1829,870,4624450,5315,-388830
12,09/10/2018,16.4 (-2.38 %),1928,3516430,1824,755,4405210,5835,-888780
13,08/10/2018,16.8 (-1.18 %),1235,2251280,1823,579,2943040,5083,-691760
14,05/10/2018,17 (-0.87 %),838,1424120,1699,514,2460580,4787,-1036460
15,04/10/2018,17.15 (0.29 %),1087,3637950,3347,627,2999870,4784,638080
16,03/10/2018,17.1 (0.88 %),892,1800380,2018,547,2435760,4453,-635380
17,02/10/2018,16.95 (-1.74 %),1288,3015100,2341,654,4621090,7066,-1605990
18,01/10/2018,17.25 (-1.43 %),848,1862980,2197,657,2903620,4420,-1040640
19,28/09/2018,17.5 (-1.69 %),1029,3086440,2999,1073,5576840,5197,-2490400
20,27/09/2018,17.8 (1.14 %),1003,3599200,3588,1145,4147780,3623,-548580
1,26/09/2018,17.6 (-0.56 %),904,2999110,3318,953,3239670,3399,-240560
2,25/09/2018,17.7 (1.14 %),1039,3217060,3096,1301,4093510,3146,-876450
3,24/09/2018,17.5 (2.04 %),750,3127600,4170,1068,3536110,3311,-408510
4,21/09/2018,17.15 (-1.15 %),926,2278210,2460,870,3209380,3689,-931170
5,20/09/2018,17.35 (0.29 %),788,2582040,3277,880,2997530,3406,-415490
6,19/09/2018,17.3 (1.76 %),978,4019510,4110,1147,3649250,3182,370260
7,18/09/2018,17 (1.80 %),1084,2855250,2634,722,3364960,4661,-509710
8,17/09/2018,16.7 (-0.89 %),941,1863530,1980,575,2084500,3625,-220970
9,14/09/2018,16.85 (-0.59 %),839,2012540,2399,553,2245620,4061,-233080
10,13/09/2018,16.95 (0.30 %),786,1853970,2359,451,1665980,3694,187990
11,12/09/2018,16.9 (-1.17 %),771,1784360,2314,491,2134200,4347,-349840
12,11/09/2018,17.1 (0.59 %),863,1992640,2309,569,1854850,3260,137790
13,10/09/2018,17 (-1.73 %),692,1982970,2866,509,2030080,3988,-47110
14,07/09/2018,17.3 (0.58 %),1072,2500120,2332,627,2612260,4166,-112140
15,06/09/2018,17.2 (-2.27 %),1148,2428820,2116,798,3004050,3764,-575230
16,05/09/2018,17.6 (1.73 %),1164,4576060,3931,1043,4140170,3969,435890
17,04/09/2018,17.3 (-2.81 %),1227,2813270,2293,819,3588210,4381,-774940
18,31/08/2018,17.8 (-1.66 %),1398,4152990,2971,1448,5065670,3498,-912680
19,30/08/2018,18.1 (4.32 %),1769,6766210,3825,2056,5777560,2810,988650
20,29/08/2018,17.35 (2.66 %),848,3013830,3554,745,2771400,3720,242430
1,28/08/2018,16.9 (-0.59 %),525,1322840,2520,644,2000840,3107,-678000
2,27/08/2018,17 (-0.87 %),703,2083440,2964,767,2718120,3544,-634680
3,24/08/2018,17.15 (0.59 %),620,2040930,3292,722,2190830,3034,-149900
4,23/08/2018,17.05 (-0.29 %),522,1531510,2934,923,2548140,2761,-1016630
5,22/08/2018,17.1 (4.59 %),1111,4518170,4067,1501,3729260,2485,788910
6,21/08/2018,16.35 (0.62 %),611,2131250,3488,520,1718090,3304,413160
7,20/08/2018,16.25 (-1.22 %),490,1094890,2234,555,1684570,3035,-589680
8,17/08/2018,16.45 (-1.50 %),585,1713070,2928,668,2288510,3426,-575440
9,16/08/2018,16.7 (0.00 %),640,1838600,2873,554,2273710,4104,-435110
10,15/08/2018,16.7 (0.30 %),525,1425760,2716,551,1734080,3147,-308320
11,14/08/2018,16.65 (-1.19 %),625,1601960,2563,589,2332280,3960,-730320
12,13/08/2018,16.85 (2.74 %),788,1975070,2506,619,1578490,2550,396580
13,10/08/2018,16.4 (-2.09 %),931,2016050,2165,523,1872550,3580,143500
14,09/08/2018,16.75 (-0.30 %),758,1651060,2178,494,1399820,2834,251240
15,08/08/2018,16.75 (-0.30 %),921,1969400,2138,541,2339810,4325,-370410
16,07/08/2018,16.8 (-0.88 %),727,1071890,1474,457,1245240,2725,-173350
17,06/08/2018,16.95 (-0.88 %),1041,2411740,2317,579,3071490,5305,-659750
18,03/08/2018,17.1 (-0.58 %),816,2509150,3075,643,2829440,4400,-320290
19,02/08/2018,17.2 (-0.58 %),935,3345980,3579,659,3275860,4971,70120
20,01/08/2018,17.3 (0.87 %),1036,4156770,4012,907,3638540,4012,518230
1,31/07/2018,17.15 (-1.72 %),1168,2530410,2166,644,3478760,5402,-948350
2,30/07/2018,17.45 (0.29 %),722,2708190,3751,633,2923040,4618,-214850
3,27/07/2018,17.4 (2.35 %),806,4028580,4998,777,3991020,5136,37560
4,26/07/2018,17 (-2.02 %),1287,2956980,2298,502,3873040,7715,-916060
5,25/07/2018,17.35 (-2.53 %),1010,3054510,3024,693,3231940,4664,-177430
6,24/07/2018,17.8 (0.56 %),722,2209130,3060,535,2884680,5392,-675550
7,23/07/2018,17.7 (-0.56 %),823,2006730,2438,472,2568310,5441,-561580
8,20/07/2018,17.8 (-1.66 %),934,2401150,2571,507,2612120,5152,-210970
9,19/07/2018,18.1 (-0.55 %),818,2113870,2584,622,2466790,3966,-352920
10,18/07/2018,18.2 (1.96 %),841,2692340,3201,724,2432420,3360,259920
11,17/07/2018,17.85 (4.39 %),1259,4182560,3322,698,3328170,4768,854390
12,16/07/2018,17.1 (-0.29 %),684,2215400,3239,422,2343930,5554,-128530
13,13/07/2018,17.15 (0.88 %),683,2071380,3033,462,2253540,4878,-182160
14,12/07/2018,17 (1.19 %),527,1887500,3582,470,2317310,4930,-429810
15,11/07/2018,16.8 (-5.88 %),936,2722070,2908,494,3271740,6623,-549670
16,10/07/2018,17.85 (0.00 %),575,2032190,3534,453,2123190,4687,-91000
17,09/07/2018,17.85 (-2.19 %),621,1945280,3132,541,2394540,4426,-449260
18,06/07/2018,18.25 (4.29 %),886,3716010,4194,607,3433830,5657,282180
19,05/07/2018,17.5 (-3.58 %),839,2900410,3457,601,3536900,5885,-636490
20,04/07/2018,18.15 (-0.82 %),639,2073570,3245,452,2467660,5459,-394090
1,03/07/2018,18.3 (0.27 %),722,3871990,5363,1078,4827170,4478,-955180
2,02/07/2018,18.25 (-3.44 %),917,3809470,4154,776,3959320,5102,-149850
3,29/06/2018,18.9 (0.00 %),333,1151030,3457,440,1333790,3031,-182760
4,28/06/2018,18.9 (0.27 %),545,2028610,3722,671,2280250,3398,-251640
5,27/06/2018,18.85 (-2.33 %),1089,2241490,2058,552,2373720,4300,-132230
6,26/06/2018,19.3 (-0.77 %),703,2506020,3565,566,3037320,5366,-531300
7,25/06/2018,19.45 (-0.77 %),681,2559560,3759,714,3245190,4545,-685630
8,22/06/2018,19.6 (2.08 %),741,3586610,4840,700,3231990,4617,354620
9,21/06/2018,19.2 (-2.29 %),665,2533400,3810,606,2848530,4701,-315130
10,20/06/2018,19.65 (5.08 %),1124,3781940,3365,762,2648700,3476,1133240
11,19/06/2018,18.7 (-5.56 %),1245,2224400,1787,800,2620950,3276,-396550
12,18/06/2018,19.8 (-5.49 %),1343,3050130,2271,1009,3919910,3885,-869780
13,15/06/2018,20.95 (-1.64 %),488,1604700,3288,411,1574600,3831,30100
14,14/06/2018,21.3 (1.67 %),819,2880610,3517,629,2717630,4321,162980
15,13/06/2018,20.95 (1.95 %),406,588060,1448,309,549130,1777,38930
16,12/06/2018,20.55 (-2.61 %),616,1048780,1703,460,1016900,2211,31880
17,11/06/2018,21.1 (-3.65 %),824,2037830,2473,582,2453480,4216,-415650
18,08/06/2018,21.9 (-0.45 %),643,1515500,2357,483,1743830,3610,-228330
19,07/06/2018,22 (-4.35 %),626,1552770,2480,704,2091020,2970,-538250
20,06/06/2018,23 (2.00 %),1357,4491980,3310,881,2542290,2886,1949690
1,05/06/2018,22.55 (0.00 %),1031,3549750,3443,1217,3007610,2471,542140
2,04/06/2018,22.55 (6.87 %),1368,4080890,2983,1049,2700650,2574,1380240
3,01/06/2018,21.1 (4.46 %),976,3645560,3735,1009,2569440,2547,1076120
4,31/05/2018,20.2 (1.51 %),726,2061930,2840,508,2086650,4108,-24720
5,30/05/2018,19.9 (-1.00 %),337,605910,1798,387,744460,1924,-138550
6,29/05/2018,20.1 (0.50 %),670,3085360,4605,597,2152280,3605,933080
7,28/05/2018,20 (-3.38 %),837,2834650,3387,1145,3268370,2854,-433720
8,25/05/2018,20.7 (1.47 %),774,3689170,4766,1345,3674090,2732,15080
9,24/05/2018,20.4 (4.08 %),826,4707770,5699,1561,4540000,2908,167770
10,23/05/2018,19.6 (6.81 %),956,3837810,4014,780,2359750,3025,1478060
11,22/05/2018,18.35 (-3.17 %),460,697440,1516,354,818530,2312,-121090
12,21/05/2018,18.95 (-1.30 %),350,284590,813,267,517910,1940,-233320
13,18/05/2018,19.2 (-2.04 %),266,321390,1208,293,798030,2724,-476640
14,17/05/2018,19.6 (0.00 %),225,402960,1791,353,735670,2084,-332710
15,16/05/2018,19.6 (0.00 %),270,502670,1862,373,722210,1936,-219540
16,15/05/2018,19.6 (1.55 %),331,895400,2705,573,1205790,2104,-310390
17,14/05/2018,19.3 (0.26 %),306,753000,2461,454,950540,2094,-197540
18,11/05/2018,19.25 (1.32 %),258,559670,2169,465,774270,1665,-214600
19,10/05/2018,19 (-1.04 %),395,944170,2390,575,1469720,2556,-525550
20,09/05/2018,19.2 (-1.03 %),433,1150430,2657,660,1492150,2261,-341720
1,08/05/2018,19.4 (2.37 %),697,2095950,3007,705,2216970,3145,-121020
2,07/05/2018,18.95 (-2.57 %),777,949830,1222,436,1512740,3470,-562910
3,04/05/2018,19.45 (0.26 %),389,1039310,2672,383,986230,2575,53080
4,03/05/2018,19.4 (-2.51 %),524,805960,1538,384,820720,2137,-14760
5,02/05/2018,19.9 (-0.50 %),524,1147390,2190,413,1028110,2489,119280
6,27/04/2018,20 (1.27 %),486,1271930,2617,440,907480,2062,364450
7,26/04/2018,19.75 (-4.36 %),583,976590,1675,595,1465490,2463,-488900
8,24/04/2018,20.65 (-1.90 %),964,3253690,3375,998,2463970,2469,789720
9,23/04/2018,21.05 (1.20 %),448,1689370,3771,888,2063140,2323,-373770
10,20/04/2018,20.8 (-0.48 %),678,1005020,1482,545,1073610,1970,-68590
11,19/04/2018,20.9 (-1.88 %),689,1235340,1793,617,1533190,2485,-297850
12,18/04/2018,21.3 (-2.52 %),497,753040,1515,771,1479140,1918,-726100
13,17/04/2018,21.85 (-0.23 %),669,1019420,1524,891,1673170,1878,-653750
14,16/04/2018,21.9 (6.31 %),1026,2599410,2534,960,1972490,2055,626920
15,13/04/2018,20.6 (-0.96 %),611,932820,1527,505,1131080,2240,-198260
16,12/04/2018,20.8 (-1.65 %),808,1050220,1300,438,931240,2126,118980
17,11/04/2018,21.15 (-3.86 %),914,1166700,1276,783,1672030,2135,-505330
18,10/04/2018,22 (3.29 %),1152,2713200,2355,914,2285030,2500,428170
19,09/04/2018,21.3 (6.76 %),1643,3137100,1909,688,2069760,3008,1067340
20,06/04/2018,25.9 (-0.19 %),960,2789060,2905,1315,3460350,2631,-671290
1,05/04/2018,25.95 (-2.08 %),791,1822390,2304,1055,2317250,2196,-494860
2,04/04/2018,26.5 (5.58 %),806,2065980,2563,1110,1878360,1692,187620
3,03/04/2018,25.1 (6.81 %),1537,3411680,2220,1182,1900870,1608,1510810
4,02/04/2018,23.5 (-5.24 %),1671,2108240,1262,1130,2442450,2161,-334210
5,30/03/2018,24.8 (-3.13 %),1213,1583270,1305,811,1874130,2311,-290860
6,29/03/2018,25.6 (-1.73 %),1194,2227910,1866,669,2244590,3355,-16680
7,28/03/2018,26.05 (-0.95 %),1303,2899300,2225,641,2798520,4366,100780
8,27/03/2018,26.3 (0.77 %),766,1689670,2206,607,1457130,2401,232540
9,26/03/2018,26.1 (-2.97 %),919,1681440,1830,701,1717830,2451,-36390
10,23/03/2018,26.9 (-2.00 %),629,1243550,1977,607,1351290,2226,-107740
11,22/03/2018,27.45 (1.67 %),784,2636160,3362,1420,2933010,2066,-296850
12,21/03/2018,27 (1.69 %),622,2232060,3589,760,2180800,2869,51260
13,20/03/2018,26.55 (0.38 %),638,1229530,1927,626,1303950,2083,-74420
14,19/03/2018,26.45 (-0.94 %),891,1782300,2000,541,2013730,3722,-231430
15,16/03/2018,26.7 (-0.56 %),669,1594540,2383,498,1956140,3928,-361600
16,15/03/2018,26.85 (-2.19 %),765,1247410,1631,604,1669810,2765,-422400
17,14/03/2018,27.45 (3.39 %),858,2436130,2839,1064,2306070,2167,130060
18,13/03/2018,26.55 (1.14 %),1236,2230100,1804,714,2301020,3223,-70920
19,12/03/2018,26.25 (-2.05 %),1097,1379200,1257,603,1684130,2793,-304930
20,09/03/2018,26.8 (-1.11 %),890,1499510,1685,542,1877770,3465,-378260
1,08/03/2018,27.1 (-2.52 %),552,1060010,1920,585,1318020,2253,-258010
2,07/03/2018,27.8 (3.35 %),1002,2912170,2906,1035,2670110,2580,242060
3,06/03/2018,26.9 (0.00 %),814,1582610,1944,563,1487680,2642,94930
4,05/03/2018,26.9 (-2.54 %),1083,1513640,1398,723,2082430,2880,-568790
5,02/03/2018,27.6 (-0.36 %),901,1721540,1911,561,1450220,2585,271320
6,01/03/2018,27.7 (-1.77 %),869,1565350,1801,603,1787660,2965,-222310
7,28/02/2018,28.2 (1.08 %),807,1838140,2278,791,1734660,2193,103480
8,27/02/2018,27.9 (-2.62 %),1276,1890300,1481,680,2030170,2986,-139870
9,26/02/2018,28.65 (0.00 %),782,2051520,2623,988,2338070,2366,-286550
10,23/02/2018,28.65 (0.70 %),978,2181970,2231,643,1700850,2645,481120
11,22/02/2018,28.45 (-3.07 %),1207,2006190,1662,879,2154630,2451,-148440
12,21/02/2018,29.35 (-0.84 %),1093,2553880,2337,899,1908080,2122,645800
13,13/02/2018,29.6 (6.86 %),1213,3750120,3092,842,2392840,2842,1357280
14,12/02/2018,27.7 (2.59 %),696,1632350,2345,619,1758820,2841,-126470
15,09/02/2018,27 (-1.46 %),989,1971820,1994,641,1712430,2671,259390
16,08/02/2018,27.4 (2.43 %),933,1913070,2050,895,1915000,2140,-1930
17,07/02/2018,26.75 (7.00 %),989,2643910,2673,321,1122180,3496,1521730
18,06/02/2018,25 (-6.89 %),845,1727380,2044,557,2574770,4623,-847390
19,05/02/2018,26.85 (-6.93 %),963,1179240,1225,551,1756960,3189,-577720
20,02/02/2018,28.85 (0.00 %),554,649940,1173,393,940090,2392,-290150
1,01/02/2018,28.85 (-3.51 %),877,1149090,1310,488,1512590,3100,-363500
2,31/01/2018,29.9 (4.18 %),1318,2402670,1823,731,2435640,3332,-32970
3,30/01/2018,28.7 (-4.33 %),1713,2429030,1418,688,2786220,4050,-357190
4,29/01/2018,30 (-5.96 %),2052,5350300,2607,844,4974460,5894,375840
5,26/01/2018,31.9 (-1.85 %),1149,2585370,2250,1051,2980170,2836,-394800
6,25/01/2018,32.5 (-0.76 %),1123,4398670,3917,1011,3931200,3888,467470
7,22/01/2018,32.75 (-0.46 %),1025,4241380,4138,943,3760880,3988,480500
8,19/01/2018,32.9 (0.30 %),622,1640070,2637,674,2512060,3727,-871990
9,18/01/2018,32.8 (-0.30 %),769,1760380,2289,470,1642540,3495,117840
10,17/01/2018,32.9 (0.16 %),1398,3221400,2304,1045,4223160,4041,-1001760
11,16/01/2018,34.35 (-1.72 %),663,1516120,2287,890,3062590,3441,-1546470
12,15/01/2018,34.95 (1.30 %),573,2088900,3646,966,2611460,2703,-522560
13,12/01/2018,34.5 (0.29 %),555,1810090,3261,937,2849540,3041,-1039450
14,11/01/2018,34.4 (1.18 %),618,2662470,4308,1041,3380110,3247,-717640
15,10/01/2018,34 (0.15 %),690,2155630,3124,726,2536760,3494,-381130
16,09/01/2018,33.95 (1.19 %),765,3096530,4048,905,2944380,3253,152150
17,08/01/2018,33.55 (2.91 %),1018,4025780,3955,1074,3163130,2945,862650
18,05/01/2018,32.6 (-0.61 %),729,2035170,2792,627,2155200,3437,-120030
19,04/01/2018,32.8 (-0.46 %),901,2500130,2775,640,2594350,4054,-94220
20,03/01/2018,32.95 (0.30 %),864,2414560,2795,624,2386960,3825,27600
1,02/01/2018,32.85 (-0.76 %),1168,3106510,2660,811,2353550,2902,752960
2,29/12/2017,33.1 (1.07 %),537,2649790,4934,995,3147500,3163,-497710
3,28/12/2017,32.75 (0.00 %),533,1622070,3043,621,2163520,3484,-541450
4,27/12/2017,32.75 (-0.15 %),777,1982370,2551,725,2595420,3580,-613050
5,26/12/2017,32.8 (0.00 %),597,1760700,2949,633,2353620,3718,-592920
6,25/12/2017,32.8 (-0.91 %),753,1884460,2503,675,2315750,3431,-431290
7,22/12/2017,33.1 (1.22 %),786,3006830,3825,866,3070450,3546,-63620
8,21/12/2017,32.7 (0.62 %),777,2314720,2979,983,2882520,2932,-567800
9,20/12/2017,32.5 (0.31 %),891,3303970,3708,1281,4221370,3295,-917400
10,19/12/2017,32.4 (-0.15 %),793,2205370,2781,902,2940010,3259,-734640
11,18/12/2017,32.45 (0.62 %),541,2008570,3713,1082,2958800,2735,-950230
12,15/12/2017,32.25 (3.70 %),1144,4680800,4092,1432,4873640,3403,-192840
13,14/12/2017,31.1 (1.80 %),809,2456220,3036,700,2819640,4028,-363420
14,13/12/2017,30.55 (-0.65 %),411,985720,2398,448,1398780,3122,-413060
15,12/12/2017,30.75 (0.65 %),1001,2230530,2228,694,3100650,4468,-870120
16,11/12/2017,30.55 (-2.08 %),929,1730410,1863,463,2198660,4749,-468250
17,08/12/2017,31.2 (0.00 %),936,1494650,1597,584,1960780,3358,-466130
18,07/12/2017,31.2 (0.16 %),916,1728830,1887,571,2501270,4381,-772440
19,06/12/2017,31.15 (-2.35 %),1087,1890600,1739,641,2117220,3303,-226620
20,05/12/2017,31.9 (-1.39 %),928,2001660,2157,764,2593520,3395,-591860
1,04/12/2017,32.35 (1.09 %),584,2183910,3740,995,2681550,2695,-497640
2,01/12/2017,32 (-0.31 %),989,2422140,2449,820,2759800,3366,-337660
3,30/11/2017,32.1 (0.00 %),580,1668340,2876,824,2197960,2667,-529620
4,29/11/2017,32.1 (0.94 %),669,2046240,3059,1123,2850730,2538,-804490
5,28/11/2017,31.8 (-1.24 %),753,1906570,2532,1025,2660560,2596,-753990
6,27/11/2017,32.2 (2.71 %),999,3565140,3569,1382,3280770,2374,284370
7,24/11/2017,31.35 (0.48 %),1107,2497790,2256,1018,2553470,2508,-55680
8,23/11/2017,31.2 (0.81 %),1111,2399440,2160,1045,3175950,3039,-776510
9,22/11/2017,30.95 (-1.43 %),964,1864240,1934,938,2178720,2323,-314480
10,21/11/2017,31.4 (0.32 %),1239,3927290,3170,1479,4317690,2919,-390400
11,20/11/2017,31.3 (2.96 %),1174,4062560,3460,1309,4359380,3330,-296820
12,17/11/2017,30.4 (-1.94 %),1478,2488100,1683,1107,2800650,2530,-312550
13,16/11/2017,31 (0.00 %),1177,3782580,3214,1515,3229350,2132,553230
14,15/11/2017,31 (4.20 %),1483,3892840,2625,1340,3703500,2764,189340
15,14/11/2017,29.75 (5.87 %),1677,4525970,2699,1558,3870770,2484,655200
16,13/11/2017,28.1 (-6.95 %),2094,3354450,1602,1185,4208970,3552,-854520
17,10/11/2017,30.2 (0.50 %),633,1370600,2165,512,1422550,2778,-51950
18,09/11/2017,30.05 (0.17 %),1088,2212390,2033,762,2694030,3535,-481640
19,08/11/2017,30 (-2.91 %),1327,2043660,1540,748,2400910,3210,-357250
20,07/11/2017,30.9 (0.32 %),749,2038810,2722,770,2169940,2818,-131130
1,06/11/2017,30.8 (0.98 %),668,1308150,1958,513,1181130,2302,127020
2,03/11/2017,30.5 (1.67 %),924,2014200,2180,720,1837200,2552,177000
3,02/11/2017,30 (-1.48 %),999,1870420,1872,783,2317110,2959,-446690
4,01/11/2017,30.45 (0.50 %),769,1352170,1758,584,1141090,1954,211080
5,31/10/2017,30.3 (-1.94 %),1468,2986100,2034,1107,2822940,2550,163160
6,30/10/2017,30.9 (-5.79 %),1509,2246230,1489,904,2796800,3094,-550570
7,27/10/2017,32.8 (-1.35 %),1464,2259590,1543,716,2663300,3720,-403710
8,26/10/2017,33.25 (-1.77 %),664,1372380,2067,520,1405070,2702,-32690
9,25/10/2017,33.85 (0.89 %),493,1026550,2082,379,898270,2370,128280
10,24/10/2017,33.55 (0.75 %),730,1417590,1942,530,1355630,2558,61960
11,23/10/2017,33.3 (-2.06 %),1231,2363660,1920,810,2570990,3174,-207330
12,20/10/2017,34 (-1.88 %),1091,3149850,2887,811,3960880,4884,-811030
13,19/10/2017,34.65 (-0.72 %),781,1496830,1917,704,2746510,3901,-1249680
14,18/10/2017,34.9 (-0.99 %),1085,2662680,2454,1297,4591010,3540,-1928330
15,17/10/2017,35.25 (1.59 %),1807,4596990,2544,2117,7075450,3342,-2478460
16,16/10/2017,34.7 (0.00 %),618,1414370,2289,781,2205190,2824,-790820
17,13/10/2017,34.7 (0.14 %),708,1502710,2122,772,2451210,3175,-948500
18,12/10/2017,34.65 (-0.29 %),685,1269840,1854,638,2015110,3158,-745270
19,11/10/2017,34.75 (-1.14 %),952,1719390,1806,1129,3520970,3119,-1801580
20,10/10/2017,35.15 (2.33 %),931,2666340,2864,1268,3875080,3056,-1208740
1,09/10/2017,34.35 (1.18 %),906,1898410,2095,699,2276240,3256,-377830
2,06/10/2017,33.95 (-0.15 %),464,1071280,2309,455,1542700,3391,-471420
3,05/10/2017,34 (-0.87 %),622,1707730,2746,738,2372750,3215,-665020
4,04/10/2017,34.3 (2.69 %),849,2140500,2521,675,1556220,2306,584280
5,03/10/2017,33.4 (-1.33 %),1373,2327930,1696,721,2534940,3516,-207010
6,02/10/2017,33.85 (-1.17 %),831,1333360,1605,500,1490830,2982,-157470
7,29/09/2017,34.25 (0.88 %),1552,3142700,2025,681,3049270,4478,93430
8,28/09/2017,33.95 (-2.16 %),1460,3034470,2078,816,3638840,4459,-604370
9,27/09/2017,34.7 (0.00 %),990,1949230,1969,609,1770210,2907,179020
10,26/09/2017,34.7 (-1.14 %),1254,2595700,2070,756,2777570,3674,-181870
11,25/09/2017,35.1 (-0.71 %),936,2110160,2254,1057,3168500,2998,-1058340
12,22/09/2017,35.35 (1.00 %),897,2305130,2570,1147,3361750,2931,-1056620
13,21/09/2017,35 (0.86 %),899,2795520,3110,959,3021110,3150,-225590
14,20/09/2017,34.7 (0.29 %),1430,3622330,2533,853,3135550,3676,486780
15,19/09/2017,34.6 (-0.57 %),1453,3217740,2215,1087,3156170,2904,61570
16,18/09/2017,34.8 (-1.42 %),2151,4623620,2150,1631,6744800,4135,-2121180
17,15/09/2017,35.3 (2.17 %),2316,5398480,2331,1783,4853160,2722,545320
18,14/09/2017,34.55 (-1.57 %),1653,2996960,1813,1147,4296180,3746,-1299220
19,13/09/2017,35.1 (0.86 %),2131,5204250,2442,1968,6326960,3215,-1122710
20,12/09/2017,34.8 (6.58 %),2095,6907350,3297,2326,5762390,2477,1144960
1,11/09/2017,32.65 (0.15 %),681,1991160,2924,842,2097960,2492,-106800
2,08/09/2017,32.6 (-1.36 %),951,2129890,2240,1037,3040160,2932,-910270
3,07/09/2017,33.05 (1.85 %),1346,3900590,2898,1562,5508230,3526,-1607640
4,06/09/2017,32.45 (1.25 %),1031,2785860,2702,662,2102470,3176,683390
5,05/09/2017,32.05 (-1.23 %),773,1242570,1607,462,1459260,3159,-216690
6,01/09/2017,32.45 (0.15 %),496,1246420,2513,717,2979440,4155,-1733020
7,31/08/2017,32.4 (0.93 %),656,1728590,2635,828,2315520,2797,-586930
8,30/08/2017,32.1 (-0.31 %),853,1752430,2054,449,2324610,5177,-572180
9,29/08/2017,32.2 (0.94 %),814,2075560,2550,762,2699280,3542,-623720
10,28/08/2017,31.9 (-0.16 %),1044,2193210,2101,495,2946590,5953,-753380
11,25/08/2017,31.95 (-0.62 %),650,1062860,1635,470,2273970,4838,-1211110
12,24/08/2017,32.15 (0.16 %),629,1205130,1916,393,1401480,3566,-196350
13,23/08/2017,32.1 (0.31 %),790,1535640,1944,433,3190060,7367,-1654420
14,22/08/2017,32 (-2.44 %),1389,2911450,2096,623,3027470,4860,-116020
15,21/08/2017,32.8 (-0.61 %),682,1397500,2049,580,1541800,2658,-144300
16,18/08/2017,33 (-0.30 %),879,1911700,2175,436,1333900,3059,577800
17,17/08/2017,33.1 (-2.22 %),893,2651620,2969,1378,3498620,2539,-847000
18,16/08/2017,33.85 (2.27 %),1023,2646890,2587,1142,2585300,2264,61590
19,15/08/2017,33.1 (-0.90 %),874,1620640,1854,770,2303740,2992,-683100
20,14/08/2017,33.4 (5.36 %),1273,3275040,2573,1248,3443480,2759,-168440
1,11/08/2017,32.2 (0.00 %),644,1416700,2200,734,1858870,2533,-442170
2,10/08/2017,32.2 (0.00 %),467,858190,1838,435,1535650,3530,-677460
3,09/08/2017,32.2 (-1.23 %),704,1480310,2103,633,1870700,2955,-390390
4,08/08/2017,32.6 (1.09 %),730,1952490,2675,784,2361540,3012,-409050
5,07/08/2017,32.25 (0.16 %),950,1774030,1867,488,1860700,3813,-86670
6,04/08/2017,32.2 (-1.23 %),668,1065760,1595,544,1327760,2441,-262000
7,03/08/2017,32.6 (1.24 %),657,1465680,2231,496,1723080,3474,-257400
8,02/08/2017,32.2 (-0.31 %),727,1517390,2087,409,1534190,3751,-16800
9,01/08/2017,32.3 (-1.82 %),955,1439060,1507,496,2150540,4336,-711480
10,31/07/2017,32.9 (-1.05 %),865,2026370,2343,780,2802090,3592,-775720
11,28/07/2017,33.25 (0.15 %),526,1295790,2463,639,1643270,2572,-347480
12,27/07/2017,33.2 (0.61 %),842,2123290,2522,1006,2222720,2209,-99430
13,26/07/2017,33 (2.01 %),0,0,,0,0,,0
14,25/07/2017,32.35 (2.37 %),613,1375300,2244,564,1107310,1963,267990
15,24/07/2017,31.6 (-1.56 %),809,1451460,1794,498,1608070,3229,-156610
16,21/07/2017,32.1 (-2.13 %),604,1264550,2094,569,1373190,2413,-108640
17,20/07/2017,32.8 (1.23 %),680,1959720,2882,838,2097430,2503,-137710
18,19/07/2017,32.4 (2.86 %),949,2331250,2457,798,2326860,2916,4390
19,18/07/2017,31.5 (-3.67 %),1257,2094180,1666,776,3023160,3896,-928980
20,17/07/2017,32.7 (-3.25 %),1524,2806260,1841,685,2666360,3892,139900
1,14/07/2017,33.8 (-1.02 %),881,1766940,2006,709,2414410,3405,-647470
2,13/07/2017,34.15 (1.34 %),1027,2239900,2181,875,2841260,3247,-601360
3,12/07/2017,33.7 (0.90 %),673,1380470,2051,601,1598410,2660,-217940
4,11/07/2017,33.4 (-1.18 %),1615,2974980,1842,677,2822990,4170,151990
5,10/07/2017,33.8 (-1.74 %),1045,1922240,1839,632,2384150,3772,-461910
6,07/07/2017,34.4 (-0.86 %),1120,2085200,1862,1047,3088670,2950,-1003470
7,06/07/2017,34.7 (1.17 %),907,1957200,2158,886,2248850,2538,-291650
8,05/07/2017,34.3 (1.63 %),955,2060370,2157,664,1885200,2839,175170
9,04/07/2017,33.75 (-1.32 %),1515,3355550,2215,672,3023050,4499,332500
10,03/07/2017,34.2 (-1.01 %),996,1906390,1914,555,1665810,3001,240580
11,30/06/2017,34.55 (-1.29 %),935,2113830,2261,664,2687960,4048,-574130
12,29/06/2017,35 (1.74 %),1023,2294980,2243,707,2199390,3111,95590
13,28/06/2017,34.4 (0.00 %),1721,4871540,2831,897,2935250,3272,1936290
14,27/06/2017,34.4 (-1.99 %),1981,4472270,2258,1017,4650500,4573,-178230
15,26/06/2017,35.1 (0.00 %),1123,2466410,2196,791,2643930,3343,-177520
16,23/06/2017,35.1 (0.29 %),1189,2284860,1922,814,2331280,2864,-46420
17,22/06/2017,35 (-0.57 %),1703,3441610,2021,1251,3853170,3080,-411560
18,21/06/2017,35.2 (5.71 %),1365,4123160,3021,1276,2907300,2278,1215860
19,20/06/2017,33.3 (0.91 %),1160,3383560,2917,1521,3308970,2176,74590
20,19/06/2017,33 (5.77 %),2074,6801770,3280,1846,5219090,2827,1582680
1,16/06/2017,31.2 (-0.48 %),653,1511800,2315,577,1766040,3061,-254240
2,15/06/2017,31.35 (-0.16 %),1355,2555290,1886,925,2557810,2765,-2520
3,14/06/2017,31.4 (0.32 %),770,2393280,3108,734,2014430,2744,378850
4,13/06/2017,31.3 (1.95 %),886,3346710,3777,572,1956050,3420,1390660
5,12/06/2017,30.7 (-4.06 %),1419,2829560,1994,516,2523190,4890,306370
6,09/06/2017,32 (0.00 %),690,2524210,3658,637,1953050,3066,571160
7,08/06/2017,32 (-1.54 %),1865,4654710,2496,800,4131520,5164,523190
8,07/06/2017,32.5 (0.00 %),934,2418880,2590,779,2512970,3226,-94090
9,06/06/2017,32.5 (0.93 %),622,1916660,3081,878,1951080,2222,-34420
10,05/06/2017,32.2 (-0.31 %),616,1631730,2649,677,1335920,1973,295810
11,02/06/2017,32.3 (0.00 %),576,1630080,2830,982,2179910,2220,-549830
12,01/06/2017,32.3 (5.90 %),973,2340210,2405,631,1502130,2381,838080
13,31/05/2017,30.5 (-2.71 %),1817,4837870,2663,946,4238560,4481,599310
14,30/05/2017,31.35 (-6.97 %),1694,3212940,1897,1276,6316430,4950,-3103490
15,29/05/2017,33.7 (2.12 %),693,1581080,2282,843,2013660,2389,-432580
16,26/05/2017,33 (1.54 %),666,1531050,2299,637,1414820,2221,116230
17,25/05/2017,32.5 (0.31 %),1168,2527980,2164,806,3016100,3742,-488120
18,24/05/2017,32.4 (6.93 %),1102,4056620,3681,1385,3927510,2836,129110
19,23/05/2017,30.3 (1.00 %),726,2640610,3637,973,2819070,2897,-178460
20,22/05/2017,30 (-1.80 %),764,2194780,2873,1065,2902150,2725,-707370
1,19/05/2017,30.55 (4.98 %),1054,2952390,2801,1024,2460140,2402,492250
2,18/05/2017,29.1 (-1.85 %),734,1636820,2230,563,1846490,3280,-209670
3,17/05/2017,29.65 (2.95 %),1345,3937600,2928,973,3661600,3763,276000
4,16/05/2017,28.8 (-4.95 %),2254,5304160,2353,1343,4988660,3715,315500
5,15/05/2017,30.3 (-1.94 %),1799,3983410,2214,1160,4046910,3489,-63500
6,12/05/2017,30.9 (-0.32 %),1193,2918860,2447,1059,2841680,2683,77180
7,11/05/2017,31 (4.20 %),1027,3892990,3791,903,3438970,3808,454020
8,10/05/2017,29.75 (4.02 %),1282,5099840,3978,1348,3894710,2889,1205130
9,09/05/2017,28.6 (0.18 %),1174,3474990,2960,995,2874690,2889,600300
10,08/05/2017,28.55 (1.96 %),1238,4176670,3374,1374,4405520,3206,-228850
11,05/05/2017,28 (3.70 %),1314,3220690,2451,959,3234720,3373,-14030
12,04/05/2017,27 (-2.17 %),1340,3099870,2313,1087,3618040,3328,-518170
13,03/05/2017,27.6 (6.98 %),1765,7477730,4237,1456,5119400,3516,2358330
14,28/04/2017,25.8 (0.98 %),493,1477530,2997,597,1614320,2704,-136790
15,27/04/2017,25.55 (0.59 %),438,1130430,2581,656,1947210,2968,-816780
16,26/04/2017,25.4 (1.60 %),551,1649320,2993,713,2022190,2836,-372870
17,25/04/2017,25 (0.00 %),316,806930,2554,423,1296360,3065,-489430
18,24/04/2017,25 (0.60 %),380,1009350,2656,470,1182870,2517,-173520
19,21/04/2017,24.85 (-0.60 %),431,1214670,2818,476,1377580,2894,-162910
20,20/04/2017,25 (0.00 %),363,1878030,5174,488,1319630,2704,558400
1,19/04/2017,25 (0.00 %),380,1178970,3103,473,1375330,2908,-196360
2,18/04/2017,25 (2.88 %),672,2354820,3504,638,1899240,2977,455580
3,17/04/2017,24.3 (-4.14 %),738,2319930,3144,780,2718350,3485,-398420
4,14/04/2017,25.35 (-0.20 %),938,3377590,3601,717,2983830,4162,393760
5,13/04/2017,25.4 (-2.31 %),957,2535240,2649,1159,4073750,3515,-1538510
6,12/04/2017,26 (1.96 %),1301,4624200,3554,1359,4434770,3263,189430
7,11/04/2017,25.5 (-0.78 %),1067,2883120,2702,1086,3908410,3599,-1025290
8,10/04/2017,25.7 (1.38 %),985,2715700,2757,1011,3231920,3197,-516220
9,07/04/2017,25.35 (1.00 %),1053,3387750,3217,1048,4015970,3832,-628220
10,05/04/2017,25.1 (1.21 %),1310,3614210,2759,1392,4582360,3292,-968150
11,04/04/2017,24.8 (2.48 %),651,1921050,2951,800,1779920,2225,141130
12,03/04/2017,24.2 (-1.22 %),478,837390,1752,465,1279800,2752,-442410
13,31/03/2017,24.5 (0.62 %),466,1091550,2342,794,1549800,1952,-458250
14,30/03/2017,24.35 (1.46 %),629,2061320,3277,734,2245110,3059,-183790
15,29/03/2017,24 (1.05 %),540,1521020,2817,678,1812900,2674,-291880
16,28/03/2017,23.75 (0.21 %),543,1201210,2212,621,1377070,2218,-175860
17,27/03/2017,23.7 (-1.66 %),909,1533570,1687,627,1958620,3124,-425050
18,24/03/2017,24.1 (-0.62 %),496,927130,1869,526,1358760,2583,-431630
19,23/03/2017,24.25 (0.00 %),588,1096040,1864,410,1123890,2741,-27850
20,22/03/2017,24.25 (0.00 %),610,1767560,2898,690,2277280,3300,-509720
1,21/03/2017,24.25 (-2.02 %),1196,1824070,1525,605,1941300,3209,-117230
2,20/03/2017,24.75 (0.00 %),460,676140,1470,491,866340,1764,-190200
3,17/03/2017,24.75 (2.06 %),622,2065240,3320,694,1486890,2142,578350
4,16/03/2017,24.25 (0.21 %),1107,2176720,1966,662,2027630,3063,149090
5,15/03/2017,24.2 (-1.63 %),1155,2453360,2124,565,1875150,3319,578210
6,14/03/2017,24.6 (0.61 %),763,2104940,2759,582,1565660,2690,539280
7,13/03/2017,24.45 (-2.40 %),1109,3203320,2888,510,2264350,4440,938970
8,10/03/2017,25.05 (-1.38 %),529,1013210,1915,444,1019360,2296,-6150
9,09/03/2017,25.4 (1.60 %),1420,2760090,1944,720,2276440,3162,483650
10,08/03/2017,25 (-3.29 %),1461,2215620,1517,563,2701350,4798,-485730
11,07/03/2017,25.85 (0.19 %),659,2080760,3157,517,1660030,3211,420730
12,06/03/2017,25.8 (0.98 %),1017,2682730,2638,708,2717050,3838,-34320
13,03/03/2017,26.55 (1.92 %),830,3157510,3804,1023,2690310,2630,467200
14,02/03/2017,26.05 (3.37 %),842,2503330,2973,654,1678690,2567,824640
15,01/03/2017,25.2 (0.80 %),852,2817610,3307,499,1622510,3252,1195100
16,28/02/2017,25 (-3.10 %),980,2051700,2094,601,1956090,3255,95610
17,27/02/2017,25.8 (-1.71 %),659,1574000,2388,452,1335140,2954,238860
18,24/02/2017,26.25 (-0.94 %),629,1421650,2260,580,1607360,2771,-185710
19,23/02/2017,26.5 (0.76 %),801,2470210,3084,738,2600600,3524,-130390
20,22/02/2017,26.3 (-0.75 %),876,2369810,2705,657,2127280,3238,242530
1,21/02/2017,26.5 (-1.12 %),921,1933800,2100,694,2446970,3526,-513170
2,20/02/2017,26.8 (3.08 %),1108,2250900,2031,773,2705870,3500,-454970
3,17/02/2017,26 (3.59 %),985,2499050,2537,602,1730510,2875,768540
4,16/02/2017,25.1 (-3.09 %),1016,1828600,1800,821,2489170,3032,-660570
5,15/02/2017,25.9 (2.78 %),817,2262920,2770,721,1949690,2704,313230
6,14/02/2017,25.2 (2.23 %),924,2238290,2422,785,2651050,3377,-412760
7,13/02/2017,24.65 (4.67 %),825,2083640,2526,721,1922480,2666,161160
8,10/02/2017,23.55 (0.43 %),626,1151010,1839,412,1021070,2478,129940
9,09/02/2017,23.45 (-0.64 %),458,689200,1505,308,788760,2561,-99560
10,08/02/2017,23.6 (-1.26 %),475,1158080,2438,389,1374020,3532,-215940
11,07/02/2017,23.9 (0.84 %),916,2099740,2292,759,1837190,2421,262550
12,06/02/2017,23.7 (1.50 %),763,1344040,1762,603,1651460,2739,-307420
13,03/02/2017,23.35 (-0.21 %),731,1747200,2390,640,2029780,3172,-282580
14,02/02/2017,23.4 (6.85 %),736,2134550,2900,434,1274490,2937,860060
15,25/01/2017,21.9 (0.46 %),872,1838260,2108,539,1646620,3055,191640
16,24/01/2017,21.8 (-3.75 %),814,1512660,1858,419,1552810,3706,-40150
17,23/01/2017,22.65 (-0.22 %),357,804320,2253,443,1093160,2468,-288840
18,20/01/2017,22.7 (-4.22 %),827,1625980,1966,715,2211480,3093,-585500
19,19/01/2017,23.7 (1.94 %),511,1423580,2786,604,1663150,2754,-239570
20,18/01/2017,23.25 (-7.00 %),1276,2860480,2242,773,4445440,5751,-1584960
1,17/01/2017,25 (6.38 %),463,1370710,2960,342,1068180,3123,302530
2,16/01/2017,23.5 (-5.24 %),471,1040590,2209,304,1354640,4456,-314050
3,13/01/2017,24.8 (-1.59 %),903,2506400,2776,563,2176740,3866,329660
4,12/01/2017,25.2 (1.00 %),607,1477600,2434,407,1206990,2966,270610
5,11/01/2017,24.95 (-0.99 %),646,1424930,2206,370,1099300,2971,325630
6,10/01/2017,25.2 (-3.08 %),794,1759510,2216,428,1331820,3112,427690
7,09/01/2017,26 (6.12 %),436,1379360,3164,267,919730,3445,459630
8,06/01/2017,24.5 (-3.54 %),660,1290960,1956,225,995550,4425,295410
9,05/01/2017,25.4 (2.01 %),574,1421540,2477,273,1170860,4289,250680
10,04/01/2017,24.9 (1.22 %),462,950570,2058,255,821090,3220,129480
11,03/01/2017,24.6 (5.13 %),478,917640,1920,314,793570,2527,124070
12,30/12/2016,23.4 (5.17 %),317,672560,2122,152,416460,2740,256100
13,29/12/2016,22.25 (-3.26 %),123,122470,996,95,244910,2578,-122440
14,28/12/2016,23 (-1.71 %),119,199110,1673,77,172610,2242,26500
15,27/12/2016,23.4 (-0.43 %),108,172750,1600,67,194830,2908,-22080
16,26/12/2016,23.5 (-2.08 %),92,123830,1346,48,184530,3844,-60700
17,23/12/2016,24 (-2.83 %),105,151160,1440,64,326620,5103,-175460
18,22/12/2016,24.7 (-0.80 %),92,117440,1277,67,216900,3237,-99460
19,21/12/2016,24.9 (0.00 %),79,103400,1309,77,145920,1895,-42520
20,20/12/2016,24.9 (-0.40 %),76,105840,1393,58,141890,2446,-36050
1,19/12/2016,25 (0.00 %),102,144430,1416,74,165420,2235,-20990
2,16/12/2016,25 (0.00 %),106,174010,1642,65,190920,2937,-16910
3,15/12/2016,25 (0.00 %),128,178100,1391,97,221430,2283,-43330
4,14/12/2016,25 (0.00 %),106,228640,2157,106,260360,2456,-31720
5,13/12/2016,25 (0.00 %),224,670270,2992,198,488850,2469,181420
6,12/12/2016,25 (-4.21 %),86,116530,1355,104,221740,2132,-105210
7,09/12/2016,26.1 (-4.04 %),117,174530,1492,116,217380,1874,-42850
8,08/12/2016,27.2 (0.37 %),68,108880,1601,77,171730,2230,-62850
9,07/12/2016,27.1 (-0.37 %),70,144910,2070,91,179340,1971,-34430
10,06/12/2016,27.2 (-0.37 %),78,146430,1877,93,211210,2271,-64780
11,05/12/2016,27.3 (0.37 %),138,260700,1889,140,317340,2267,-56640
12,02/12/2016,28.2 (0.00 %),207,411310,1987,139,407630,2933,3680
13,01/12/2016,28.2 (-4.08 %),229,382000,1668,159,507500,3192,-125500
14,30/11/2016,29.4 (0.00 %),142,373220,2628,98,339280,3462,33940
15,29/11/2016,29.4 (0.00 %),111,225020,2027,93,286360,3079,-61340
16,28/11/2016,29.4 (-1.67 %),101,200980,1990,115,467730,4067,-266750
17,25/11/2016,29.9 (-4.17 %),235,727910,3097,434,1049450,2418,-321540
18,17/11/2016,29.3 (1.74 %),182,468100,2572,143,390700,2732,77400
19,16/11/2016,28.8 (-0.35 %),115,189300,1646,86,190900,2220,-1600
20,15/11/2016,28.9 (0.35 %),144,293900,2041,101,211600,2095,82300
1,14/11/2016,28.8 (-0.69 %),93,118700,1276,69,144500,2094,-25800
2,11/11/2016,29 (-0.34 %),55,112100,2038,88,200800,2282,-88700
3,10/11/2016,29.1 (0.34 %),114,252100,2211,143,269500,1885,-17400
4,09/11/2016,29 (-1.02 %),147,255500,1738,146,294500,2017,-39000
5,08/11/2016,29.3 (-0.68 %),103,222800,2163,140,262800,1877,-40000
6,07/11/2016,29.5 (3.87 %),153,442900,2895,143,333400,2331,109500
7,04/11/2016,28.4 (0.00 %),105,176200,1678,89,182600,2052,-6400
8,03/11/2016,28.4 (-2.07 %),161,300200,1865,148,362800,2451,-62600
9,02/11/2016,29 (-1.69 %),100,123300,1233,82,170200,2076,-46900
10,01/11/2016,29.5 (0.00 %),106,167800,1583,80,120900,1511,46900
11,31/10/2016,29.5 (0.00 %),102,203800,1998,119,225900,1898,-22100
12,28/10/2016,29.5 (-0.34 %),140,312700,2234,140,327700,2341,-15000
13,27/10/2016,29.6 (-0.34 %),108,235300,2179,131,279600,2134,-44300
14,26/10/2016,29.7 (0.34 %),158,317000,2006,95,202200,2128,114800
15,25/10/2016,29.6 (-0.67 %),133,234200,1761,137,320000,2336,-85800
16,24/10/2016,29.8 (-0.67 %),84,107200,1276,126,201400,1598,-94200
17,21/10/2016,30 (-2.60 %),222,619100,2789,176,675900,3840,-56800
18,20/10/2016,30.8 (-0.96 %),192,456900,2380,174,530400,3048,-73500
19,19/10/2016,31.1 (0.00 %),145,299300,2064,185,341700,1847,-42400
20,18/10/2016,31.1 (0.65 %),266,717200,2696,258,570000,2209,147200
1,17/10/2016,30.9 (-1.59 %),147,197500,1344,146,281800,1930,-84300
2,14/10/2016,31.4 (0.00 %),209,320800,1535,142,338400,2383,-17600
3,13/10/2016,31.4 (0.00 %),297,786100,2647,243,808000,3325,-21900
4,12/10/2016,31.4 (0.96 %),375,1137000,3032,311,1156100,3717,-19100
5,11/10/2016,31.1 (0.32 %),183,493900,2699,178,445200,2501,48700
6,10/10/2016,31 (0.00 %),202,415800,2058,177,377000,2130,38800
7,07/10/2016,31 (0.00 %),150,320300,2135,142,377400,2658,-57100
8,06/10/2016,31 (1.64 %),195,414300,2125,186,418300,2249,-4000
9,05/10/2016,30.5 (0.33 %),128,288500,2254,145,314000,2166,-25500
10,04/10/2016,30.4 (-0.98 %),206,497000,2413,153,486500,3180,10500
11,03/10/2016,30.7 (0.00 %),180,456400,2536,151,435300,2883,21100
12,30/09/2016,30.7 (-1.29 %),269,611100,2272,179,522100,2917,89000
13,29/09/2016,31.1 (0.65 %),201,752700,3745,255,728800,2858,23900
14,28/09/2016,30.9 (1.31 %),190,572900,3015,204,539800,2646,33100
15,27/09/2016,30.5 (2.01 %),246,695500,2827,276,706200,2559,-10700
16,26/09/2016,29.9 (-1.97 %),253,374700,1481,210,441100,2100,-66400
17,23/09/2016,30.5 (-1.93 %),210,284200,1353,138,392200,2842,-108000
18,22/09/2016,31.1 (0.32 %),300,467200,1557,163,549500,3371,-82300
19,21/09/2016,31 (4.73 %),408,577900,1416,238,568200,2387,9700
20,20/09/2016,29.6 (1.02 %),217,421200,1941,167,469100,2809,-47900
1,19/09/2016,29.3 (1.38 %),201,686400,3415,206,747300,3628,-60900
2,16/09/2016,28.9 (-1.03 %),173,388000,2243,187,409100,2188,-21100
3,15/09/2016,29.2 (1.39 %),209,456500,2184,209,472900,2263,-16400
4,14/09/2016,28.8 (-0.69 %),433,1355300,3130,351,1361600,3879,-6300
5,13/09/2016,29 (-9.38 %),405,639200,1578,326,790000,2423,-150800
6,12/09/2016,32 (-2.74 %),117,205700,1758,135,428800,3176,-223100
7,09/09/2016,32.9 (0.00 %),94,214600,2283,144,311600,2164,-97000
8,08/09/2016,32.9 (-0.30 %),90,146600,1629,94,249200,2651,-102600
9,07/09/2016,33 (0.00 %),97,339700,3502,132,408900,3098,-69200
10,06/09/2016,33 (-0.30 %),107,175600,1641,128,254400,1988,-78800
11,05/09/2016,33.1 (0.30 %),87,170300,1957,132,163300,1237,7000
12,01/09/2016,33 (0.30 %),64,119500,1867,96,145600,1517,-26100
13,31/08/2016,32.9 (-0.60 %),70,103800,1483,137,183800,1342,-80000
14,30/08/2016,33.1 (0.00 %),51,96000,1882,91,105100,1155,-9100
15,29/08/2016,33.1 (0.00 %),144,445100,3091,165,415100,2516,30000
16,26/08/2016,33.1 (-1.49 %),159,319100,2007,189,397600,2104,-78500
17,25/08/2016,33.6 (-0.88 %),69,107200,1554,123,223400,1816,-116200
18,24/08/2016,33.9 (0.30 %),78,312800,4010,144,363600,2525,-50800
19,23/08/2016,33.8 (1.50 %),142,486100,3423,138,340900,2470,145200
20,22/08/2016,33.3 (-1.48 %),152,332000,2184,120,230500,1921,101500
1,19/08/2016,33.8 (-1.17 %),99,199800,2018,139,239700,1724,-39900
2,18/08/2016,34.2 (0.59 %),184,373000,2027,181,443500,2450,-70500
3,17/08/2016,34 (-0.29 %),210,562500,2679,209,601800,2879,-39300
4,16/08/2016,34.1 (0.29 %),199,485700,2441,210,521200,2482,-35500
5,15/08/2016,34 (0.00 %),132,457700,3467,171,460300,2692,-2600
6,12/08/2016,34 (1.19 %),337,747600,2218,253,626200,2475,121400
7,11/08/2016,33.6 (-1.75 %),309,594600,1924,245,691200,2821,-96600
8,10/08/2016,34.2 (0.29 %),211,458700,2174,200,495800,2479,-37100
9,09/08/2016,34.1 (2.71 %),258,608700,2359,149,403800,2710,204900
10,08/08/2016,33.2 (0.30 %),117,284500,2432,107,225400,2107,59100
11,05/08/2016,33.1 (0.00 %),151,514800,3409,157,383400,2442,131400
12,04/08/2016,33.1 (0.00 %),216,578900,2680,222,509100,2293,69800
13,03/08/2016,33.1 (0.30 %),232,647200,2790,282,666500,2363,-19300
14,02/08/2016,33 (-2.94 %),381,856500,2248,335,784000,2340,72500
15,01/08/2016,34 (-4.49 %),590,794100,1346,304,855100,2813,-61000
16,29/07/2016,35.6 (0.28 %),389,442900,1139,259,583500,2253,-140600
17,28/07/2016,35.5 (2.90 %),403,726600,1803,211,602000,2853,124600
18,27/07/2016,34.5 (1.47 %),308,655300,2128,220,630900,2868,24400
19,26/07/2016,34 (-0.29 %),254,586700,2310,140,529300,3781,57400
20,25/07/2016,34.1 (2.40 %),320,753600,2355,221,676900,3063,76700
1,22/07/2016,33.3 (0.30 %),249,611300,2455,190,564300,2970,47000
2,21/07/2016,33.2 (3.11 %),305,687200,2253,263,554300,2108,132900
3,20/07/2016,32.2 (0.31 %),257,666800,2595,279,694200,2488,-27400
4,19/07/2016,32.1 (-1.53 %),298,443400,1488,323,584100,1808,-140700
5,18/07/2016,32.6 (8.67 %),366,1650700,4510,588,1408300,2395,242400
6,15/07/2016,30 (0.00 %),182,398000,2187,170,452200,2660,-54200
7,14/07/2016,30 (-3.23 %),312,657200,2106,272,767800,2823,-110600
8,13/07/2016,31 (0.32 %),181,405800,2242,208,468100,2250,-62300
9,12/07/2016,30.9 (6.19 %),339,1035200,3054,472,941800,1995,93400
10,11/07/2016,29.1 (-5.21 %),458,929900,2030,312,886200,2840,43700
11,08/07/2016,30.7 (-2.85 %),297,416500,1402,207,474500,2292,-58000
12,07/07/2016,31.6 (1.94 %),296,365700,1235,252,424500,1685,-58800
13,06/07/2016,31 (-1.59 %),319,389700,1222,162,352800,2178,36900
14,05/07/2016,31.5 (-0.94 %),289,341500,1182,182,366600,2014,-25100
15,04/07/2016,31.8 (4.95 %),328,722600,2203,253,689800,2726,32800
16,01/07/2016,30.3 (1.00 %),298,845900,2839,264,852700,3230,-6800
17,30/06/2016,30 (1.69 %),330,593000,1797,343,660300,1925,-67300
18,29/06/2016,29.5 (-0.34 %),293,527400,1800,291,462900,1591,64500
19,28/06/2016,29.6 (6.86 %),475,1169800,2463,565,1060500,1877,109300
20,27/06/2016,27.7 (2.97 %),335,737800,2202,394,746500,1895,-8700
1,24/06/2016,26.9 (-2.18 %),530,1456100,2747,403,1267700,3146,188400
2,23/06/2016,27.5 (-0.72 %),236,486700,2062,254,533900,2102,-47200
3,22/06/2016,27.7 (-0.36 %),153,370200,2420,237,485600,2049,-115400
4,21/06/2016,27.8 (2.58 %),282,1235000,4379,313,1097200,3505,137800
5,20/06/2016,27.1 (-0.73 %),407,1266300,3111,303,938900,3099,327400
6,17/06/2016,27.3 (-3.53 %),473,1523200,3220,307,1528600,4979,-5400
7,16/06/2016,28.3 (4.04 %),379,1288300,3399,332,799100,2407,489200
8,15/06/2016,27.2 (-1.81 %),366,1308600,3575,269,1007200,3744,301400
9,14/06/2016,27.7 (-0.36 %),476,1745300,3667,278,1052700,3787,692600
10,13/06/2016,27.8 (-2.11 %),383,1392500,3636,202,898400,4448,494100
11,10/06/2016,28.4 (3.27 %),805,1478800,1837,282,1533900,5439,-55100
12,09/06/2016,27.5 (10.00 %),476,1639500,3444,328,1394900,4253,244600
13,08/06/2016,25 (-0.79 %),151,261400,1731,109,305800,2806,-44400
14,07/06/2016,25.2 (2.02 %),174,535300,3076,241,461400,1915,73900
15,06/06/2016,24.7 (-0.80 %),214,587000,2743,199,630200,3167,-43200
16,03/06/2016,24.9 (0.00 %),141,467400,3315,187,561100,3001,-93700
17,02/06/2016,24.9 (2.89 %),179,1004800,5613,208,842600,4051,162200
18,01/06/2016,24.2 (0.00 %),183,527400,2882,194,493400,2543,34000
19,31/05/2016,24.2 (-2.42 %),298,505400,1696,182,540000,2967,-34600
20,30/05/2016,24.8 (0.00 %),224,461200,2059,163,431100,2645,30100
1,27/05/2016,24.8 (2.90 %),373,892900,2394,279,870900,3122,22000
2,26/05/2016,24.1 (0.00 %),132,292000,2212,143,279200,1952,12800
3,25/05/2016,24.1 (0.00 %),257,897200,3491,290,861100,2969,36100
4,24/05/2016,24.1 (7.11 %),555,1811700,3264,475,1225500,2580,586200
5,23/05/2016,22.5 (0.00 %),137,270900,1977,166,267600,1612,3300
6,20/05/2016,22.5 (-0.88 %),162,237700,1467,162,314300,1940,-76600
7,19/05/2016,22.7 (0.44 %),263,362700,1379,190,311500,1639,51200
8,18/05/2016,22.6 (-3.42 %),346,834500,2412,342,986200,2884,-151700
9,17/05/2016,23.4 (0.00 %),341,700900,2055,297,796700,2682,-95800
10,16/05/2016,23.4 (7.83 %),375,1251500,3337,358,857900,2396,393600
11,13/05/2016,21.7 (-0.91 %),390,625800,1605,277,689800,2490,-64000
12,12/05/2016,21.9 (-0.45 %),407,992100,2438,283,856400,3026,135700
13,11/05/2016,22 (9.45 %),372,718200,1931,277,618600,2233,99600
14,10/05/2016,20.1 (4.15 %),220,464500,2111,179,305900,1709,158600
15,09/05/2016,19.3 (1.05 %),158,309700,1960,151,271300,1797,38400
16,06/05/2016,19.1 (0.00 %),127,400000,3150,188,419900,2234,-19900
17,05/05/2016,19.1 (-0.52 %),169,466100,2758,125,363700,2910,102400
18,04/05/2016,19.2 (2.67 %),208,450600,2166,165,391900,2375,58700
19,29/04/2016,18.7 (0.00 %),124,375400,3027,110,335300,3048,40100
20,28/04/2016,18.7 (2.19 %),236,629400,2667,199,463800,2331,165600
1,27/04/2016,18.3 (0.00 %),121,328900,2718,100,258900,2589,70000
2,26/04/2016,18.3 (1.10 %),215,546500,2542,152,523500,3444,23000
3,25/04/2016,18.1 (-1.63 %),144,467800,3249,133,371500,2793,96300
4,22/04/2016,18.4 (0.00 %),141,347300,2463,157,422600,2692,-75300
5,21/04/2016,18.4 (1.10 %),178,1065300,5985,226,1164700,5154,-99400
6,20/04/2016,18.2 (8.33 %),382,2080500,5446,487,1718400,3529,362100
7,19/04/2016,16.8 (-0.59 %),130,379700,2921,148,418700,2829,-39000
8,15/04/2016,16.9 (0.00 %),87,279000,3207,117,318500,2722,-39500
9,14/04/2016,16.9 (0.00 %),103,316000,3068,84,276200,3288,39800
10,13/04/2016,16.9 (2.42 %),263,822800,3129,197,817800,4151,5000
11,12/04/2016,16.5 (-0.60 %),121,310200,2564,105,360300,3431,-50100
12,11/04/2016,16.6 (1.22 %),119,305800,2570,113,333200,2949,-27400
13,08/04/2016,16.4 (-2.38 %),209,456100,2182,122,532100,4361,-76000
14,07/04/2016,16.8 (1.20 %),108,370400,3430,100,299000,2990,71400
15,06/04/2016,17.3 (0.58 %),102,535100,5246,162,449200,2773,85900
16,05/04/2016,17.2 (2.38 %),103,451000,4379,123,363100,2952,87900
17,04/04/2016,16.8 (0.00 %),78,252300,3235,103,260100,2525,-7800
18,01/04/2016,16.8 (0.00 %),148,343600,2322,119,320300,2692,23300
19,31/03/2016,16.8 (-4.00 %),138,482600,3497,206,671500,3260,-188900
20,30/03/2016,17.5 (2.94 %),296,1190700,4023,240,836500,3485,354200
1,29/03/2016,17 (0.00 %),130,499800,3845,200,485900,2430,13900
2,28/03/2016,17 (0.59 %),129,482300,3739,151,516400,3420,-34100
3,25/03/2016,16.9 (0.60 %),166,503000,3030,219,586200,2677,-83200
4,24/03/2016,16.8 (-3.45 %),241,732800,3041,245,815200,3327,-82400
5,23/03/2016,17.4 (1.16 %),214,605700,2830,213,682500,3204,-76800
6,22/03/2016,17.2 (4.24 %),322,1035900,3217,290,910600,3140,125300
7,21/03/2016,16.5 (0.61 %),362,707200,1954,259,949800,3667,-242600
8,18/03/2016,16.4 (0.61 %),117,512200,4378,157,553400,3525,-41200
9,17/03/2016,16.3 (3.16 %),388,1195000,3080,289,1306300,4520,-111300
10,16/03/2016,15.8 (0.00 %),108,263300,2438,132,328600,2489,-65300
11,15/03/2016,15.8 (-1.25 %),175,541600,3095,170,565200,3325,-23600
12,14/03/2016,16 (1.27 %),177,516500,2918,184,502800,2733,13700
13,11/03/2016,15.8 (-1.25 %),224,710900,3174,271,837000,3089,-126100
14,10/03/2016,16 (7.38 %),340,1126300,3313,358,1118000,3123,8300
15,09/03/2016,14.9 (0.00 %),99,269000,2717,82,325600,3971,-56600
16,08/03/2016,14.9 (-0.67 %),88,307900,3499,107,288600,2697,19300
17,07/03/2016,15 (0.67 %),254,641700,2526,237,702200,2963,-60500
18,04/03/2016,14.9 (0.00 %),95,281300,2961,115,293100,2549,-11800
19,03/03/2016,14.9 (-0.67 %),67,249400,3722,136,464200,3413,-214800
20,02/03/2016,15 (3.45 %),188,678100,3607,259,727000,2807,-48900
1,01/03/2016,14.5 (0.69 %),74,233400,3154,82,239900,2926,-6500
2,29/02/2016,14.4 (-1.37 %),72,238800,3317,77,261000,3390,-22200
3,26/02/2016,14.6 (-0.68 %),86,217900,2534,97,321200,3311,-103300
4,25/02/2016,14.7 (0.68 %),124,334900,2701,166,604400,3641,-269500
5,24/02/2016,14.6 (0.69 %),151,426100,2822,100,395800,3958,30300
6,23/02/2016,14.5 (-2.03 %),119,298900,2512,117,393300,3362,-94400
7,22/02/2016,14.8 (-1.33 %),87,234200,2692,121,344600,2848,-110400
8,19/02/2016,15 (-0.66 %),130,457500,3519,159,494700,3111,-37200
9,18/02/2016,15.1 (0.67 %),102,399100,3913,153,420800,2750,-21700
10,17/02/2016,15 (1.35 %),119,610800,5133,201,725700,3610,-114900
11,16/02/2016,14.8 (0.00 %),187,658000,3519,191,664700,3480,-6700
12,15/02/2016,14.8 (4.23 %),88,257200,2923,86,203300,2364,53900
13,05/02/2016,14.2 (-0.70 %),40,205300,5133,83,206500,2488,-1200
14,04/02/2016,14.3 (0.70 %),70,574200,8203,102,299500,2936,274700
15,03/02/2016,14.2 (-1.39 %),137,697600,5092,152,627500,4128,70100
16,02/02/2016,14.4 (1.41 %),215,1166800,5427,204,858400,4208,308400
17,01/02/2016,14.2 (4.41 %),199,1554700,7813,193,1044500,5412,510200
18,29/01/2016,13.6 (-4.23 %),217,405700,1870,200,566900,2835,-161200
19,28/01/2016,14.2 (0.71 %),137,307500,2245,163,515800,3164,-208300
20,27/01/2016,14.1 (0.71 %),268,699300,2609,239,685800,2869,13500
1,26/01/2016,14 (-9.68 %),225,677600,3012,243,910500,3747,-232900
2,25/01/2016,15.5 (0.00 %),208,574400,2762,181,585100,3233,-10700
3,22/01/2016,15.5 (-1.27 %),221,659500,2984,196,644000,3286,15500
4,21/01/2016,15.7 (6.80 %),393,1222700,3111,261,1130100,4330,92600
5,20/01/2016,14.7 (1.38 %),361,1048400,2904,234,1062100,4539,-13700
6,19/01/2016,14.5 (0.69 %),200,443100,2216,111,457600,4123,-14500
7,18/01/2016,14.4 (-3.36 %),222,715400,3223,199,738300,3710,-22900
8,15/01/2016,14.9 (2.76 %),177,721700,4077,231,831000,3597,-109300
9,14/01/2016,14.5 (4.32 %),196,965200,4924,332,1029400,3101,-64200
10,13/01/2016,13.9 (-2.80 %),116,280500,2418,192,465900,2427,-185400
11,12/01/2016,14.3 (3.62 %),199,1212000,6090,312,1158800,3714,53200
12,11/01/2016,13.8 (5.34 %),127,805100,6339,253,878900,3474,-73800
13,08/01/2016,13.1 (-0.76 %),121,455000,3760,119,356900,2999,98100
14,07/01/2016,13.2 (0.00 %),156,439900,2820,177,601300,3397,-161400
15,06/01/2016,13.2 (-2.22 %),174,415000,2385,196,636100,3245,-221100
16,05/01/2016,13.5 (7.14 %),257,2038400,7932,459,2143000,4669,-104600
17,04/01/2016,12.6 (2.44 %),124,439800,3547,186,485300,2609,-45500
18,31/12/2015,12.3 (-1.60 %),111,316400,2850,183,502900,2748,-186500
19,30/12/2015,12.5 (8.70 %),276,1394200,5051,296,1271600,4296,122600
20,29/12/2015,11.5 (1.77 %),157,531400,3385,212,751700,3546,-220300
1,28/12/2015,11.3 (3.67 %),111,718000,6468,114,637300,5590,80700
2,25/12/2015,10.9 (0.93 %),145,797700,5501,150,935000,6233,-137300
3,24/12/2015,10.8 (-0.92 %),56,186900,3338,44,241900,5498,-55000
4,23/12/2015,10.9 (0.00 %),58,135300,2333,47,150200,3196,-14900
5,22/12/2015,10.9 (-0.91 %),51,127600,2502,46,175500,3815,-47900
6,21/12/2015,11 (-1.79 %),43,111600,2595,58,236900,4084,-125300
7,18/12/2015,11.2 (-0.88 %),43,123200,2865,73,257900,3533,-134700
8,17/12/2015,11.3 (0.89 %),38,126800,3337,68,207900,3057,-81100
9,16/12/2015,11.2 (0.00 %),55,170300,3096,80,269300,3366,-99000
10,15/12/2015,11.2 (0.90 %),50,210000,4200,65,221700,3411,-11700
11,14/12/2015,11.1 (0.00 %),48,159300,3319,73,216800,2970,-57500
12,11/12/2015,11.1 (0.91 %),57,200800,3523,77,186100,2417,14700
13,10/12/2015,11 (-2.65 %),45,199400,4431,91,289000,3176,-89600
14,09/12/2015,11.3 (-0.88 %),66,225100,3411,130,336100,2585,-111000
15,08/12/2015,11.4 (1.79 %),77,297000,3857,118,325500,2758,-28500
16,07/12/2015,11.2 (0.00 %),205,595800,2906,248,788600,3180,-192800
17,04/12/2015,11.2 (3.70 %),139,433000,3115,103,347000,3369,86000
18,03/12/2015,10.8 (-1.82 %),42,123500,2940,73,206200,2825,-82700
19,02/12/2015,11 (0.00 %),40,204100,5103,94,276300,2939,-72200
20,01/12/2015,11 (1.85 %),46,191500,4163,58,138100,2381,53400
1,30/11/2015,10.8 (-2.70 %),55,165900,3016,80,256800,3210,-90900
2,27/11/2015,11.1 (-1.77 %),49,220600,4502,141,432200,3065,-211600
3,26/11/2015,11.3 (0.00 %),69,323100,4683,138,412200,2987,-89100
4,25/11/2015,11.3 (0.89 %),83,362500,4367,149,526000,3530,-163500
5,24/11/2015,11.2 (-1.75 %),103,432700,4201,183,498600,2725,-65900
6,23/11/2015,11.4 (1.79 %),131,882500,6737,272,925200,3401,-42700
7,20/11/2015,11.2 (1.82 %),121,747800,6180,252,872600,3463,-124800
8,19/11/2015,11 (3.77 %),114,529800,4647,230,524200,2279,5600
9,18/11/2015,10.6 (0.95 %),114,316700,2778,123,405700,3298,-89000
10,17/11/2015,10.5 (0.00 %),155,617800,3986,131,621900,4747,-4100
11,16/11/2015,10.5 (-1.87 %),148,372800,2519,86,384600,4472,-11800
12,13/11/2015,10.7 (0.94 %),137,390700,2852,79,506300,6409,-115600
13,12/11/2015,10.6 (-2.75 %),135,368400,2729,97,432100,4455,-63700
14,11/11/2015,10.9 (-2.68 %),100,308200,3082,133,527500,3966,-219300
15,10/11/2015,11.2 (-0.88 %),122,435000,3566,145,689200,4753,-254200
16,09/11/2015,11.3 (1.80 %),142,635100,4473,215,795900,3702,-160800
17,06/11/2015,11.1 (1.83 %),212,678600,3201,246,770400,3132,-91800
18,05/11/2015,10.9 (-0.91 %),156,499000,3199,224,594600,2654,-95600
19,04/11/2015,11 (-2.65 %),127,385100,3032,190,490100,2579,-105000
20,03/11/2015,11.3 (-3.42 %),143,478400,3345,238,677600,2847,-199200
1,02/11/2015,11.7 (3.54 %),251,894500,3564,366,1244000,3399,-349500
2,30/10/2015,11.3 (9.71 %),407,1211700,2977,273,827500,3031,384200
3,29/10/2015,10.3 (0.98 %),86,157100,1827,75,215000,2867,-57900
4,28/10/2015,10.2 (0.99 %),57,74800,1312,58,138300,2384,-63500
5,27/10/2015,10.1 (-2.88 %),77,112400,1460,91,219800,2415,-107400
6,26/10/2015,10.4 (0.00 %),53,99100,1870,70,249300,3561,-150200
7,23/10/2015,10.4 (0.00 %),55,150700,2740,91,263300,2893,-112600
8,22/10/2015,10.4 (0.97 %),79,125000,1582,65,210400,3237,-85400
9,21/10/2015,10.3 (0.00 %),77,145000,1883,60,226300,3772,-81300
10,20/10/2015,10.3 (-0.96 %),59,103500,1754,57,173900,3051,-70400
11,19/10/2015,10.4 (1.96 %),100,218800,2188,62,246900,3982,-28100
12,16/10/2015,10.2 (-3.77 %),182,549000,3016,91,743000,8165,-194000
13,15/10/2015,10.6 (-1.85 %),66,156500,2371,65,225300,3466,-68800
14,14/10/2015,10.8 (0.00 %),82,225800,2754,74,314600,4251,-88800
15,13/10/2015,10.8 (0.93 %),154,418700,2719,85,468400,5511,-49700
16,12/10/2015,10.7 (0.00 %),75,389700,5196,98,378700,3864,11000
17,09/10/2015,10.7 (0.94 %),76,309000,4066,120,441100,3676,-132100
18,08/10/2015,10.6 (-1.85 %),96,351900,3666,112,434400,3879,-82500
19,07/10/2015,10.8 (0.00 %),69,365900,5303,141,469200,3328,-103300
20,06/10/2015,10.8 (0.93 %),102,320000,3137,102,339300,3326,-19300
1,05/10/2015,10.7 (1.90 %),75,319200,4256,109,404000,3706,-84800
2,02/10/2015,10.5 (2.94 %),82,304200,3710,86,358400,4167,-54200
3,01/10/2015,10.2 (-0.97 %),67,104300,1557,55,182200,3313,-77900
4,30/09/2015,10.3 (0.00 %),76,119000,1566,59,176600,2993,-57600
5,29/09/2015,10.3 (-2.83 %),109,193100,1772,83,284200,3424,-91100
6,28/09/2015,10.6 (0.00 %),102,147700,1448,102,289500,2838,-141800
7,25/09/2015,13.3 (3.91 %),213,578800,2717,300,708500,2362,-129700
8,24/09/2015,12.8 (4.07 %),160,466900,2918,113,382600,3386,84300
9,23/09/2015,12.3 (-0.81 %),82,176800,2156,66,246400,3733,-69600
10,22/09/2015,12.4 (0.81 %),48,88500,1844,44,108200,2459,-19700
11,21/09/2015,12.3 (-0.81 %),49,121800,2486,62,260000,4194,-138200
12,18/09/2015,12.4 (0.81 %),55,131800,2396,59,279000,4729,-147200
13,17/09/2015,12.3 (0.00 %),155,382600,2468,79,456700,5781,-74100
14,16/09/2015,12.3 (1.65 %),116,412400,3555,124,516600,4166,-104200
15,15/09/2015,12.1 (-1.63 %),35,115000,3286,42,198500,4726,-83500
16,14/09/2015,12.3 (0.00 %),131,399100,3047,110,465700,4234,-66600
17,11/09/2015,12.3 (2.50 %),165,649500,3936,106,669400,6315,-19900
18,10/09/2015,12 (-1.64 %),47,108000,2298,31,123600,3987,-15600
19,09/09/2015,12.2 (0.00 %),57,165700,2907,48,199000,4146,-33300
20,08/09/2015,12.2 (-0.81 %),75,190600,2541,50,234000,4680,-43400
1,07/09/2015,12.3 (0.00 %),101,342800,3394,72,404100,5613,-61300
2,04/09/2015,12.3 (1.65 %),47,144300,3070,41,167500,4085,-23200
3,03/09/2015,12.1 (0.83 %),79,149200,1889,52,109900,2113,39300
4,01/09/2015,12 (-3.23 %),140,427800,3056,68,464900,6837,-37100
5,31/08/2015,12.4 (-0.80 %),158,468900,2968,78,456200,5849,12700
6,28/08/2015,12.5 (0.81 %),104,395200,3800,70,411300,5876,-16100
7,27/08/2015,12.4 (-2.36 %),131,470700,3593,89,453100,5091,17600
8,26/08/2015,12.7 (3.25 %),136,465200,3421,80,417300,5216,47900
9,25/08/2015,12.3 (2.50 %),121,397800,3288,76,290100,3817,107700
10,24/08/2015,12 (-9.09 %),93,231100,2485,113,336600,2979,-105500
11,21/08/2015,13.2 (-1.49 %),86,456000,5302,116,612800,5283,-156800
12,20/08/2015,13.4 (-1.47 %),58,174000,3000,151,434000,2874,-260000
13,19/08/2015,13.6 (6.25 %),161,467100,2901,253,706200,2791,-239100
14,18/08/2015,12.8 (-0.78 %),30,57800,1927,41,139700,3407,-81900
15,17/08/2015,12.9 (0.00 %),77,152100,1975,81,184000,2272,-31900
16,14/08/2015,12.9 (0.00 %),45,73500,1633,55,209600,3811,-136100
17,13/08/2015,12.9 (-2.27 %),60,115100,1918,64,186900,2920,-71800
18,12/08/2015,13.2 (0.00 %),59,179000,3034,71,206700,2911,-27700
19,11/08/2015,13.2 (-0.75 %),86,191400,2226,79,234000,2962,-42600
20,10/08/2015,13.3 (-0.75 %),86,174500,2029,92,216200,2350,-41700
1,07/08/2015,13.4 (-0.74 %),26,56800,2185,72,147000,2042,-90200
2,06/08/2015,13.5 (0.00 %),38,86900,2287,80,171900,2149,-85000
3,05/08/2015,13.5 (0.00 %),48,113500,2365,55,114300,2078,-800
4,04/08/2015,13.5 (0.00 %),56,130000,2321,80,205100,2564,-75100
5,03/08/2015,13.5 (0.00 %),60,163400,2723,70,207900,2970,-44500
6,31/07/2015,13.5 (0.00 %),55,155300,2824,83,182700,2201,-27400
7,30/07/2015,13.5 (0.00 %),86,212000,2465,67,250100,3733,-38100
8,29/07/2015,13.5 (-0.74 %),41,84300,2056,62,175100,2824,-90800
9,28/07/2015,13.6 (-0.73 %),48,138600,2888,82,196400,2395,-57800
10,27/07/2015,13.7 (2.24 %),98,263500,2689,111,327100,2947,-63600
11,24/07/2015,13.4 (-2.19 %),51,83000,1627,90,254100,2823,-171100
12,23/07/2015,13.7 (0.00 %),68,87900,1293,91,279900,3076,-192000
13,22/07/2015,13.7 (1.48 %),59,142700,2419,129,308100,2388,-165400
14,21/07/2015,13.5 (1.50 %),118,463700,3930,204,467100,2290,-3400
15,20/07/2015,13.3 (-2.21 %),74,164300,2220,116,304100,2622,-139800
16,17/07/2015,13.6 (-0.73 %),37,59200,1600,155,357100,2304,-297900
17,16/07/2015,13.7 (-0.72 %),76,425200,5595,249,734200,2949,-309000
18,15/07/2015,13.8 (0.00 %),65,260000,4000,180,452200,2512,-192200
19,14/07/2015,13.8 (0.00 %),83,323400,3896,194,556600,2869,-233200
20,13/07/2015,13.8 (2.22 %),89,379500,4264,148,388500,2625,-9000
1,10/07/2015,13.5 (1.50 %),90,497600,5529,183,574400,3139,-76800
2,09/07/2015,13.3 (-0.75 %),64,421100,6580,155,542200,3498,-121100
3,08/07/2015,13.4 (-0.74 %),94,529000,5628,173,702600,4061,-173600
4,07/07/2015,13.5 (1.50 %),77,409300,5316,230,695800,3025,-286500
5,06/07/2015,13.3 (-0.75 %),78,469000,6013,254,767300,3021,-298300
6,03/07/2015,13.4 (2.29 %),95,371700,3913,157,378700,2412,-7000
7,02/07/2015,13.1 (0.77 %),87,346400,3982,92,239700,2605,106700
8,01/07/2015,13 (0.00 %),72,255100,3543,94,300100,3193,-45000
9,30/06/2015,13 (0.00 %),109,478300,4388,100,461300,4613,17000
10,29/06/2015,13 (0.00 %),109,361700,3318,97,353800,3647,7900
11,26/06/2015,13 (0.00 %),84,183200,2181,93,322800,3471,-139600
12,25/06/2015,13 (-1.52 %),66,177700,2692,88,291100,3308,-113400
13,24/06/2015,13.2 (0.76 %),94,253200,2694,119,382100,3211,-128900
14,23/06/2015,13.1 (-0.76 %),110,161100,1465,83,228000,2747,-66900
15,22/06/2015,13.2 (-0.75 %),189,456200,2414,117,472500,4038,-16300
16,19/06/2015,13.3 (-2.21 %),97,242900,2504,147,458800,3121,-215900
17,18/06/2015,13.6 (2.26 %),103,299900,2912,134,325000,2425,-25100
18,17/06/2015,13.3 (2.31 %),250,620800,2483,201,783200,3897,-162400
19,16/06/2015,13 (-1.52 %),171,387000,2263,128,400800,3131,-13800
20,15/06/2015,13.2 (-1.49 %),103,203900,1980,102,349500,3426,-145600
1,12/06/2015,13.4 (-2.19 %),154,347000,2253,120,463400,3862,-116400
2,11/06/2015,13.7 (0.00 %),148,331200,2238,114,372200,3265,-41000
3,10/06/2015,13.7 (0.00 %),109,237100,2175,100,264300,2643,-27200
4,09/06/2015,13.7 (-3.52 %),183,434500,2374,231,629200,2724,-194700
5,08/06/2015,14.2 (7.58 %),321,1432100,4461,435,1412000,3246,20100
6,05/06/2015,13.2 (1.54 %),85,286200,3367,117,486700,4160,-200500
7,04/06/2015,13 (-0.76 %),97,319400,3293,101,363900,3603,-44500
8,03/06/2015,13.1 (0.77 %),119,456200,3834,107,497800,4652,-41600
9,02/06/2015,13 (-1.52 %),108,425000,3935,111,502100,4523,-77100
10,01/06/2015,13.2 (-0.75 %),107,214600,2006,101,254500,2520,-39900
11,29/05/2015,13.3 (0.00 %),80,222600,2783,117,351200,3002,-128600
12,28/05/2015,13.3 (1.53 %),119,617700,5191,166,469600,2829,148100
13,27/05/2015,13.1 (-0.76 %),84,243600,2900,93,223100,2399,20500
14,26/05/2015,13.2 (-0.75 %),83,282300,3401,147,404800,2754,-122500
15,25/05/2015,13.3 (2.31 %),97,324200,3342,111,313000,2820,11200
16,22/05/2015,13 (0.78 %),110,208400,1895,70,202000,2886,6400
17,21/05/2015,12.9 (-0.77 %),97,149100,1537,101,330600,3273,-181500
18,20/05/2015,13 (2.36 %),162,298000,1840,117,313600,2680,-15600
19,19/05/2015,12.7 (-2.31 %),75,178600,2381,94,259500,2761,-80900
20,18/05/2015,13 (-4.41 %),101,207100,2050,105,435500,4148,-228400
1,15/05/2015,13.6 (-0.73 %),168,725700,4320,248,964000,3887,-238300
2,14/05/2015,13.7 (1.48 %),200,618100,3091,302,825700,2734,-207600
3,13/05/2015,13.5 (3.05 %),101,399600,3956,142,359700,2533,39900
4,12/05/2015,13.1 (0.77 %),136,381000,2801,161,556700,3458,-175700
5,11/05/2015,13 (0.00 %),60,210900,3515,90,301600,3351,-90700
6,08/05/2015,13 (0.00 %),62,199800,3223,84,210500,2506,-10700
7,07/05/2015,13 (2.36 %),57,298800,5242,70,251800,3597,47000
8,06/05/2015,12.7 (-1.55 %),68,469900,6910,118,475000,4025,-5100
9,05/05/2015,12.9 (-0.77 %),97,260000,2680,89,257300,2891,2700
10,04/05/2015,13 (0.00 %),103,802100,7787,184,795300,4322,6800
11,27/04/2015,13 (0.00 %),50,290200,5804,101,435600,4313,-145400
12,24/04/2015,13 (0.78 %),61,225900,3703,110,286300,2603,-60400
13,23/04/2015,12.9 (-0.77 %),71,424400,5977,156,402900,2583,21500
14,22/04/2015,13 (0.00 %),80,422300,5279,188,519500,2763,-97200
15,21/04/2015,13 (0.00 %),102,592100,5805,204,722900,3544,-130800
16,20/04/2015,13 (0.00 %),122,485600,3980,197,521400,2647,-35800
17,17/04/2015,13 (4.84 %),235,1592500,6777,547,1669800,3053,-77300
18,16/04/2015,12.4 (-1.59 %),195,904500,4638,210,786100,3743,118400
19,15/04/2015,12.6 (0.80 %),149,1013400,6801,131,694000,5298,319400
20,14/04/2015,12.5 (0.00 %),188,1232600,6556,172,1179600,6858,53000
1,13/04/2015,12.5 (-2.34 %),127,329200,2592,124,731100,5896,-401900
2,10/04/2015,12.8 (-1.54 %),53,141800,2675,148,575400,3888,-433600
3,09/04/2015,13 (2.36 %),62,473000,7629,143,445100,3113,27900
4,08/04/2015,12.7 (1.60 %),62,197900,3192,83,170900,2059,27000
5,07/04/2015,12.5 (0.81 %),70,203900,2913,62,187300,3021,16600
6,06/04/2015,12.4 (0.00 %),55,177600,3229,56,181000,3232,-3400
7,03/04/2015,12.4 (-0.80 %),66,124200,1882,63,104700,1662,19500
8,02/04/2015,12.5 (1.63 %),143,266300,1862,94,198900,2116,67400
9,01/04/2015,12.3 (-2.38 %),92,338100,3675,83,306900,3698,31200
10,31/03/2015,12.6 (1.61 %),114,308100,2703,75,168800,2251,139300
11,30/03/2015,12.4 (-3.13 %),173,364000,2104,129,521700,4044,-157700
12,27/03/2015,12.8 (-1.54 %),140,321500,2296,133,1102000,8286,-780500
13,26/03/2015,13 (0.00 %),86,647400,7528,139,616800,4437,30600
14,25/03/2015,13 (-0.76 %),145,339300,2340,95,350000,3684,-10700
15,24/03/2015,13.1 (0.77 %),89,800000,8989,166,625700,3769,174300
16,23/03/2015,13 (-0.76 %),105,527500,5024,112,550800,4918,-23300
17,20/03/2015,13.1 (0.00 %),95,398100,4191,76,266500,3507,131600
18,19/03/2015,13.1 (1.55 %),142,609300,4291,132,472800,3582,136500
19,18/03/2015,12.9 (-1.53 %),199,518100,2604,107,418900,3915,99200
20,17/03/2015,13.1 (0.77 %),171,616600,3606,109,562700,5162,53900
1,16/03/2015,13 (-1.52 %),197,450700,2288,122,515000,4221,-64300
2,13/03/2015,13.2 (-0.75 %),132,367300,2783,111,369000,3324,-1700
3,12/03/2015,13.3 (0.00 %),159,464700,2923,135,473700,3509,-9000
4,11/03/2015,13.3 (-0.75 %),137,284100,2074,98,390900,3989,-106800
5,10/03/2015,13.4 (0.00 %),132,264900,2007,111,397800,3584,-132900
6,09/03/2015,13.4 (-1.47 %),123,392300,3189,124,460400,3713,-68100
7,06/03/2015,13.6 (-0.73 %),124,452400,3648,173,608800,3519,-156400
8,05/03/2015,13.7 (1.48 %),234,922800,3944,326,1055900,3239,-133100
9,04/03/2015,13.5 (0.00 %),115,477900,4156,169,578900,3425,-101000
10,03/03/2015,13.5 (1.50 %),174,687600,3952,151,556500,3685,131100
11,02/03/2015,13.3 (-2.21 %),121,352600,2914,201,597500,2973,-244900
12,27/02/2015,13.6 (4.62 %),265,1119300,4224,379,1041700,2749,77600
13,26/02/2015,13 (-0.76 %),167,469400,2811,113,526500,4659,-57100
14,25/02/2015,13.1 (0.00 %),115,346600,3014,133,388800,2923,-42200
15,24/02/2015,13.1 (0.77 %),96,183900,1916,82,215900,2633,-32000
16,13/02/2015,13 (0.00 %),98,313700,3201,98,789900,8060,-476200
17,12/02/2015,13 (0.78 %),72,217700,3024,124,562800,4539,-345100
18,11/02/2015,12.9 (-0.77 %),95,330500,3479,89,325300,3655,5200
19,10/02/2015,13 (0.00 %),70,438200,6260,131,522000,3985,-83800
20,09/02/2015,13 (0.00 %),122,560700,4596,134,505700,3774,55000
1,06/02/2015,13 (0.78 %),136,621200,4568,165,600600,3640,20600
2,05/02/2015,12.9 (-0.77 %),127,342000,2693,135,512600,3797,-170600
3,04/02/2015,13 (0.78 %),159,1280500,8053,290,1080600,3726,199900
4,03/02/2015,12.9 (-0.77 %),354,1898300,5362,375,1769300,4718,129000
5,02/02/2015,13 (0.00 %),179,388800,2172,183,480000,2623,-91200
6,30/01/2015,13 (-2.26 %),252,579200,2298,212,693900,3273,-114700
7,29/01/2015,13.3 (0.76 %),206,571800,2776,153,543900,3555,27900
8,28/01/2015,13.2 (-0.75 %),227,490700,2162,151,521500,3454,-30800
9,27/01/2015,13.3 (-2.21 %),367,1006700,2743,266,1222700,4597,-216000
10,26/01/2015,13.6 (0.74 %),197,691400,3510,285,730600,2564,-39200
11,23/01/2015,13.5 (0.00 %),264,857100,3247,250,831000,3324,26100
12,22/01/2015,13.5 (0.75 %),247,517200,2094,170,498500,2932,18700
13,21/01/2015,13.4 (0.00 %),213,454100,2132,165,484500,2936,-30400
14,20/01/2015,13.4 (-1.47 %),312,762400,2444,189,996100,5270,-233700
15,19/01/2015,13.6 (-0.73 %),199,480500,2415,199,693400,3484,-212900
16,16/01/2015,13.7 (0.00 %),369,990200,2683,265,879700,3320,110500
17,15/01/2015,13.7 (-0.72 %),365,951600,2607,280,1165500,4163,-213900
18,14/01/2015,13.8 (0.00 %),223,536500,2406,193,546900,2834,-10400
19,13/01/2015,13.8 (2.22 %),298,746600,2505,287,819900,2857,-73300
20,12/01/2015,13.5 (-2.88 %),659,1517500,2303,307,1617000,5267,-99500
1,09/01/2015,13.9 (-2.11 %),461,925400,2007,323,1227700,3801,-302300
2,08/01/2015,14.2 (-2.07 %),248,491400,1981,235,703800,2995,-212400
3,07/01/2015,14.5 (3.57 %),507,1457600,2875,589,1651800,2804,-194200
4,06/01/2015,14 (1.45 %),314,723800,2305,249,628500,2524,95300
5,05/01/2015,13.8 (-0.72 %),193,426200,2208,248,627800,2531,-201600
6,31/12/2014,13.9 (3.73 %),354,1088600,3075,357,1060400,2970,28200
7,30/12/2014,13.4 (2.29 %),291,757800,2604,205,539700,2633,218100
8,29/12/2014,13.1 (-2.96 %),238,491400,2065,222,593500,2673,-102100
9,26/12/2014,13.5 (-0.74 %),295,654800,2220,261,522500,2002,132300
10,25/12/2014,13.6 (-1.45 %),303,815100,2690,219,669300,3056,145800
11,24/12/2014,13.8 (0.73 %),293,760600,2596,260,743200,2858,17400
12,23/12/2014,13.7 (-4.20 %),414,1165500,2815,426,1566300,3677,-400800
13,22/12/2014,14.3 (8.33 %),489,1231700,2519,265,918500,3466,313200
14,19/12/2014,13.2 (-6.38 %),938,2305100,2457,423,1977000,4674,328100
15,18/12/2014,14.1 (-9.62 %),1300,3609900,2777,680,3978200,5850,-368300
16,17/12/2014,15.6 (-3.11 %),730,2518100,3449,421,2457800,5838,60300
17,16/12/2014,16.1 (-3.59 %),452,1214900,2688,329,1188500,3612,26400
18,15/12/2014,16.7 (0.00 %),297,877600,2955,220,936300,4256,-58700
19,12/12/2014,16.7 (0.60 %),331,819900,2477,207,867600,4191,-47700
20,11/12/2014,16.6 (-2.35 %),433,1048000,2420,288,1318200,4577,-270200
1,10/12/2014,17 (4.29 %),507,1749000,3450,372,1379100,3707,369900
2,09/12/2014,16.3 (-7.39 %),560,2109100,3766,380,2053000,5403,56100
3,08/12/2014,17.6 (1.15 %),302,1462600,4843,402,1702500,4235,-239900
4,05/12/2014,17.4 (-0.57 %),586,1892300,3229,414,1946700,4702,-54400
5,04/12/2014,17.5 (-1.69 %),491,1665400,3392,516,2025200,3925,-359800
6,03/12/2014,17.8 (-0.56 %),390,1627100,4172,621,1942500,3128,-315400
7,02/12/2014,17.9 (1.13 %),403,1653300,4102,660,2114200,3203,-460900
8,01/12/2014,17.7 (0.00 %),609,2154900,3538,740,2870700,3879,-715800
9,28/11/2014,17.7 (5.99 %),724,4029600,5566,1239,4533600,3659,-504000
10,27/11/2014,16.7 (3.09 %),348,1405200,4038,355,1042400,2936,362800
11,26/11/2014,16.2 (-1.82 %),592,2411000,4073,869,3116900,3587,-705900
12,25/11/2014,16.5 (0.00 %),196,490000,2500,279,793800,2845,-303800
13,24/11/2014,16.5 (1.23 %),241,1115600,4629,437,1402100,3208,-286500
14,21/11/2014,16.3 (1.88 %),811,3475700,4286,1390,4180700,3008,-705000
15,20/11/2014,16 (0.63 %),231,751200,3252,273,887700,3252,-136500
16,19/11/2014,15.9 (-0.62 %),196,512400,2614,255,697800,2736,-185400
17,18/11/2014,16 (1.27 %),531,2119400,3991,638,2330600,3653,-211200
18,17/11/2014,15.8 (0.00 %),127,355900,2802,137,467600,3413,-111700
19,14/11/2014,15.8 (-1.86 %),151,311600,2064,133,410600,3087,-99000
20,13/11/2014,16.1 (0.00 %),97,280000,2887,175,467000,2669,-187000
1,12/11/2014,16.1 (1.90 %),136,448900,3301,136,461100,3390,-12200
2,11/11/2014,15.8 (-2.47 %),162,530100,3272,201,732000,3642,-201900
3,10/11/2014,16.2 (0.00 %),136,398900,2933,256,812000,3172,-413100
4,07/11/2014,16.2 (0.00 %),112,306000,2732,189,447300,2367,-141300
5,06/11/2014,16.2 (3.85 %),215,824000,3833,400,965300,2413,-141300
6,05/11/2014,15.6 (0.00 %),69,196200,2843,67,215900,3222,-19700
7,04/11/2014,15.6 (-1.27 %),43,190700,4435,93,196000,2108,-5300
8,03/11/2014,15.8 (1.28 %),92,300000,3261,153,309000,2020,-9000
9,31/10/2014,15.6 (1.30 %),75,312500,4167,118,250500,2123,62000
10,30/10/2014,15.4 (-0.65 %),63,173700,2757,103,246100,2389,-72400
11,29/10/2014,15.5 (2.65 %),88,253100,2876,85,158700,1867,94400
12,28/10/2014,15.1 (-0.66 %),118,179100,1518,70,161300,2304,17800
13,27/10/2014,15.2 (-1.94 %),92,141400,1537,92,197000,2141,-55600
14,24/10/2014,15.5 (0.00 %),90,140000,1556,89,232700,2615,-92700
15,23/10/2014,15.5 (-1.27 %),93,182800,1966,92,312500,3397,-129700
16,22/10/2014,15.7 (0.64 %),86,202100,2350,97,202000,2082,100
17,21/10/2014,15.6 (0.65 %),88,237000,2693,106,209100,1973,27900
18,20/10/2014,15.5 (-0.64 %),78,120000,1538,106,202100,1907,-82100
19,17/10/2014,15.6 (1.96 %),120,312900,2608,111,239800,2160,73100
20,16/10/2014,15.3 (-3.77 %),229,557100,2433,125,439400,3515,117700
1,15/10/2014,15.9 (0.00 %),155,306700,1979,99,300000,3030,6700
2,14/10/2014,15.9 (-2.45 %),107,293800,2746,137,479100,3497,-185300
3,13/10/2014,16.3 (1.24 %),152,336900,2216,116,345900,2982,-9000
4,10/10/2014,16.1 (-1.83 %),193,401300,2079,149,453100,3041,-51800
5,09/10/2014,16.4 (0.00 %),150,360500,2403,159,481700,3030,-121200
6,08/10/2014,16.4 (0.61 %),272,562300,2067,240,718600,2994,-156300
7,07/10/2014,16.3 (-2.40 %),316,904700,2863,245,1082300,4418,-177600
8,06/10/2014,16.7 (0.00 %),108,281500,2606,254,570100,2244,-288600
9,03/10/2014,16.7 (1.21 %),154,620600,4030,352,752400,2138,-131800
10,02/10/2014,16.5 (2.48 %),211,632700,2999,300,801700,2672,-169000
11,01/10/2014,16.1 (2.55 %),135,519200,3846,168,598100,3560,-78900
12,30/09/2014,15.7 (-0.63 %),181,386500,2135,99,309100,3122,77400
13,29/09/2014,15.8 (-1.25 %),152,486100,3198,124,474600,3827,11500
14,26/09/2014,16 (-1.23 %),144,310500,2156,164,474600,2894,-164100
15,25/09/2014,16.2 (0.00 %),237,375300,1584,152,379100,2494,-3800
16,24/09/2014,16.2 (0.62 %),215,443900,2065,157,560400,3569,-116500
17,23/09/2014,16.1 (-1.23 %),267,749100,2806,230,634500,2759,114600
18,22/09/2014,16.3 (-1.81 %),171,406800,2379,212,649600,3064,-242800
19,19/09/2014,16.6 (-0.60 %),117,263800,2255,187,573800,3068,-310000
20,18/09/2014,16.7 (1.21 %),328,1529700,4664,527,1862200,3534,-332500
1,17/09/2014,16.5 (-1.20 %),255,840500,3296,298,1097900,3684,-257400
2,16/09/2014,16.7 (0.00 %),256,703700,2749,206,618800,3004,84900
3,15/09/2014,16.7 (-0.60 %),222,665000,2995,371,1011300,2726,-346300
4,12/09/2014,16.8 (0.60 %),295,940900,3189,221,804300,3639,136600
5,11/09/2014,16.7 (-0.60 %),275,958600,3486,266,1014300,3813,-55700
6,10/09/2014,16.8 (0.60 %),277,697300,2517,242,595200,2460,102100
7,05/09/2014,16.7 (0.60 %),247,605900,2453,225,626000,2782,-20100
8,04/09/2014,16.6 (-1.78 %),312,636900,2041,238,837700,3520,-200800
9,29/08/2014,16.8 (0.00 %),274,580000,2117,214,484600,2264,95400
10,26/08/2014,17.1 (8.92 %),1246,2698700,2166,442,1750900,3961,947800
11,21/08/2014,20.4 (-0.97 %),399,1170100,2933,257,1135800,4419,34300
12,20/08/2014,20.6 (-0.48 %),254,523100,2059,200,595900,2980,-72800
13,19/08/2014,20.7 (-2.82 %),403,1017200,2524,278,1190400,4282,-173200
14,18/08/2014,0 (0.00 %),390,1216900,3120,315,1273500,4043,-56600
15,15/08/2014,0 (0.00 %),254,610600,2404,280,947800,3385,-337200
16,13/08/2014,0 (0.00 %),437,2166600,4958,322,1742800,5412,423800
17,12/08/2014,0 (0.00 %),55,114600,2084,99,220800,2230,-106200
18,11/08/2014,0 (0.00 %),80,224200,2803,140,364500,2604,-140300
19,08/08/2014,0 (0.00 %),212,520500,2455,254,586400,2309,-65900
20,07/08/2014,0 (0.00 %),56,136700,2441,66,191800,2906,-55100
1,06/08/2014,18.7 (0.00 %),82,181500,2213,98,250800,2559,-69300
2,05/08/2014,18.7 (1.63 %),113,248800,2202,116,361400,3116,-112600
3,04/08/2014,18.4 (0.55 %),87,142600,1639,68,133700,1966,8900
4,01/08/2014,18.3 (-0.54 %),93,232400,2499,93,279100,3001,-46700
5,31/07/2014,18.4 (0.55 %),143,381000,2664,83,228700,2755,152300
6,30/07/2014,18.3 (-1.08 %),84,330200,3931,77,314900,4090,15300
7,29/07/2014,18.5 (0.00 %),119,256200,2153,114,210200,1844,46000
8,28/07/2014,18.5 (-2.63 %),180,446800,2482,166,425600,2564,21200
9,25/07/2014,19 (-2.56 %),114,365600,3207,165,470800,2853,-105200
10,24/07/2014,19.5 (1.56 %),175,688400,3934,158,491900,3113,196500
11,23/07/2014,19.2 (-0.52 %),67,160500,2396,118,268500,2275,-108000
12,22/07/2014,19.3 (0.00 %),93,280300,3014,101,188300,1864,92000
13,21/07/2014,19.3 (-1.53 %),150,333600,2224,151,399000,2642,-65400
14,18/07/2014,19.6 (0.00 %),179,385600,2154,112,481000,4295,-95400
15,17/07/2014,19.6 (0.00 %),179,359900,2011,137,476600,3479,-116700
16,16/07/2014,19.6 (-0.51 %),154,429800,2791,201,643700,3202,-213900
17,14/07/2014,19.6 (1.03 %),107,336800,3148,106,216400,2042,120400
18,11/07/2014,19.4 (-1.52 %),192,569700,2967,157,556400,3544,13300
19,10/07/2014,19.7 (-2.96 %),253,695400,2749,224,657600,2936,37800
20,09/07/2014,0 (0.00 %),160,377300,2358,189,440900,2333,-63600
1,08/07/2014,19.8 (3.13 %),182,741600,4075,193,625600,3241,116000
2,07/07/2014,19.2 (0.00 %),128,480000,3750,156,564300,3617,-84300
3,04/07/2014,19.2 (0.00 %),142,469100,3304,186,616700,3316,-147600
4,03/07/2014,19.2 (2.67 %),264,1074300,4069,248,1017000,4101,57300
5,02/07/2014,18.7 (3.31 %),220,709100,3223,243,564900,2325,144200
6,01/07/2014,18.1 (0.56 %),129,395800,3068,146,356100,2439,39700
7,30/06/2014,18 (0.00 %),97,259600,2676,104,220500,2120,39100
8,27/06/2014,18 (-1.10 %),89,218900,2460,108,404500,3745,-185600
9,26/06/2014,18.2 (0.55 %),105,328100,3125,132,448100,3395,-120000
10,25/06/2014,18.1 (1.69 %),103,381000,3699,142,267100,1881,113900
11,24/06/2014,17.8 (1.14 %),71,257400,3625,108,197200,1826,60200
12,23/06/2014,17.6 (-0.56 %),68,299500,4404,112,286100,2554,13400
13,20/06/2014,17.7 (-0.56 %),80,175000,2188,104,263000,2529,-88000
14,19/06/2014,17.8 (-0.56 %),168,361900,2154,143,399600,2794,-37700
15,18/06/2014,17.9 (1.70 %),188,550200,2927,181,615900,3403,-65700
16,17/06/2014,18.6 (0.00 %),170,399400,2349,132,451600,3421,-52200
17,16/06/2014,18.6 (-0.53 %),100,298900,2989,111,347000,3126,-48100
18,13/06/2014,18.7 (0.54 %),132,410700,3111,114,285000,2500,125700
19,12/06/2014,18.6 (-1.06 %),108,359000,3324,146,543900,3725,-184900
20,11/06/2014,18.8 (1.62 %),154,495200,3216,144,409800,2846,85400
1,10/06/2014,18.5 (0.54 %),188,699000,3718,262,713000,2721,-14000
2,09/06/2014,18.4 (0.00 %),132,260500,1973,131,291600,2226,-31100
3,06/06/2014,18.4 (1.66 %),98,290100,2960,78,173900,2229,116200
4,05/06/2014,18.1 (1.12 %),101,236400,2341,114,142000,1246,94400
5,04/06/2014,17.9 (-1.10 %),147,343900,2339,99,347300,3508,-3400
6,03/06/2014,18.1 (0.56 %),140,339100,2422,116,281600,2428,57500
7,02/06/2014,18 (-2.70 %),212,547900,2584,189,520900,2756,27000
8,30/05/2014,18.5 (-2.12 %),185,428600,2317,149,475000,3188,-46400
9,29/05/2014,18.9 (-2.58 %),283,922000,3258,228,719000,3154,203000
10,28/05/2014,19.4 (6.01 %),372,1169000,3142,361,978700,2711,190300
11,27/05/2014,18.3 (2.23 %),190,792700,4172,188,647600,3445,145100
12,26/05/2014,17.9 (0.56 %),123,411700,3347,98,254300,2595,157400
13,23/05/2014,17.8 (-0.56 %),115,414300,3603,103,254400,2470,159900
14,22/05/2014,17.9 (-3.24 %),236,776000,3288,216,977200,4524,-201200
15,21/05/2014,18.5 (2.78 %),199,729800,3667,204,779300,3820,-49500
16,20/05/2014,18 (7.14 %),150,656300,4375,175,497400,2842,158900
17,19/05/2014,16.8 (0.60 %),143,345200,2414,123,377600,3070,-32400
18,16/05/2014,16.7 (3.09 %),130,493800,3798,119,365900,3075,127900
19,15/05/2014,16.2 (-2.41 %),199,501600,2521,152,502800,3308,-1200
20,14/05/2014,16.6 (5.73 %),138,463400,3358,108,357900,3314,105500
1,13/05/2014,15.7 (1.29 %),168,680600,4051,188,606500,3226,74100
2,12/05/2014,15.5 (-7.74 %),170,766000,4506,126,585300,4645,180700
3,09/05/2014,16.8 (3.70 %),193,700400,3629,157,439800,2801,260600
4,08/05/2014,16.2 (-10.00 %),253,811500,3208,209,1104500,5285,-293000
5,07/05/2014,18 (-1.10 %),78,178900,2294,69,166600,2414,12300
6,06/05/2014,18.2 (-0.55 %),155,556600,3591,149,520100,3491,36500
7,05/05/2014,18.3 (-6.63 %),120,394600,3288,93,384300,4132,10300
8,29/04/2014,19.6 (1.03 %),62,153800,2481,59,150000,2542,3800
9,28/04/2014,19.4 (-0.51 %),67,186400,2782,81,183400,2264,3000
10,25/04/2014,19.5 (0.52 %),108,295700,2738,98,230800,2355,64900
11,24/04/2014,19.4 (-0.51 %),90,227800,2531,84,224400,2671,3400
12,23/04/2014,19.5 (-2.50 %),102,186800,1831,81,222700,2749,-35900
13,22/04/2014,20 (2.56 %),228,660300,2896,183,399500,2183,260800
14,21/04/2014,19.5 (-4.41 %),113,323500,2863,128,399600,3122,-76100
15,18/04/2014,20.4 (-5.12 %),150,544800,3632,188,725900,3861,-181100
16,17/04/2014,21.5 (3.37 %),132,669000,5068,130,369700,2844,299300
17,16/04/2014,20.8 (-3.26 %),220,485100,2205,147,556900,3788,-71800
18,15/04/2014,21.5 (-4.87 %),282,601200,2132,159,748900,4710,-147700
19,14/04/2014,22.6 (-1.74 %),270,611500,2265,142,682900,4809,-71400
20,11/04/2014,23 (-1.71 %),227,582700,2567,141,732300,5194,-149600
1,10/04/2014,23.4 (-2.50 %),144,337600,2344,205,669900,3268,-332300
2,08/04/2014,24 (4.35 %),205,858600,4188,345,862900,2501,-4300
3,07/04/2014,23 (0.88 %),112,382000,3411,134,455900,3402,-73900
4,04/04/2014,22.8 (-1.72 %),248,768400,3098,176,878800,4993,-110400
5,03/04/2014,23.2 (0.87 %),154,508800,3304,105,426000,4057,82800
6,02/04/2014,23 (-0.86 %),171,600900,3514,202,741200,3669,-140300
7,01/04/2014,23.2 (-2.52 %),162,718200,4433,183,744200,4067,-26000
8,31/03/2014,23.8 (1.71 %),154,861200,5592,182,531800,2922,329400
9,28/03/2014,23.4 (-0.43 %),164,664900,4054,137,490600,3581,174300
10,27/03/2014,23.5 (-0.42 %),270,951100,3523,169,639300,3783,311800
11,26/03/2014,23.6 (-4.84 %),348,1535800,4413,262,1436700,5484,99100
12,25/03/2014,24.8 (-3.50 %),191,703400,3683,247,992300,4017,-288900
13,24/03/2014,25.7 (2.39 %),252,1323700,5253,345,1212800,3515,110900
14,21/03/2014,25.1 (0.40 %),273,1074700,3937,201,1052000,5234,22700
15,20/03/2014,25 (0.00 %),171,737400,4312,216,592800,2744,144600
16,19/03/2014,25 (0.00 %),227,1149100,5062,189,782800,4142,366300
17,18/03/2014,25 (0.00 %),222,1113400,5015,240,917400,3823,196000
18,17/03/2014,25 (0.40 %),235,1165100,4958,193,853800,4424,311300
19,14/03/2014,24.9 (-2.35 %),517,1896200,3668,258,1728900,6701,167300
20,13/03/2014,25.5 (-1.54 %),268,1060600,3957,165,676300,4099,384300
1,12/03/2014,25.9 (0.78 %),185,1384000,7481,352,1014100,2881,369900
2,11/03/2014,25.7 (5.33 %),310,1991800,6425,595,1901800,3196,90000
3,10/03/2014,24.4 (0.41 %),110,852200,7747,260,803900,3092,48300
4,07/03/2014,24.3 (0.00 %),168,1044000,6214,335,1036500,3094,7500
5,06/03/2014,24.3 (7.05 %),373,2101500,5634,597,1896800,3177,204700
6,05/03/2014,22.7 (1.34 %),162,694900,4290,191,511500,2678,183400
7,04/03/2014,22.4 (1.82 %),235,1115800,4748,215,661600,3077,454200
8,03/03/2014,22 (-4.76 %),301,803000,2668,256,944100,3688,-141100
9,28/02/2014,23.1 (0.00 %),302,914400,3028,198,889600,4493,24800
10,27/02/2014,23.1 (-2.12 %),242,685000,2831,233,997200,4280,-312200
11,26/02/2014,23.6 (-1.26 %),332,880600,2652,231,998900,4324,-118300
12,25/02/2014,23.9 (0.00 %),261,834100,3196,289,1190700,4120,-356600
13,24/02/2014,23.9 (0.42 %),230,675600,2937,193,932600,4832,-257000
14,21/02/2014,23.8 (4.85 %),342,1585800,4637,390,1537100,3941,48700
15,20/02/2014,22.7 (-7.72 %),468,1286500,2749,291,1349000,4636,-62500
16,19/02/2014,24.6 (1.65 %),344,1246200,3623,316,1275100,4035,-28900
17,18/02/2014,24.2 (0.41 %),244,879200,3603,234,875700,3742,3500
18,17/02/2014,24.1 (2.99 %),557,1903700,3418,378,1786000,4725,117700
19,14/02/2014,23.4 (0.00 %),203,850000,4187,205,869900,4243,-19900
20,13/02/2014,23.4 (-1.27 %),309,1120700,3627,215,924600,4300,196100
1,12/02/2014,23.7 (3.04 %),181,929000,5133,171,586200,3428,342800
2,11/02/2014,23 (-4.56 %),198,622400,3143,197,1053400,5347,-431000
3,10/02/2014,24.1 (5.24 %),308,1195700,3882,232,926800,3995,268900
4,07/02/2014,22.9 (-2.14 %),213,730500,3430,158,728600,4611,1900
5,06/02/2014,23.4 (0.86 %),128,518600,4052,123,319500,2598,199100
6,27/01/2014,23.2 (1.31 %),183,597600,3266,124,487600,3932,110000
7,24/01/2014,22.9 (-1.29 %),181,532700,2943,158,529300,3350,3400
8,23/01/2014,23.2 (3.11 %),166,610800,3680,197,728500,3698,-117700
9,22/01/2014,22.5 (1.81 %),335,961200,2869,276,1154100,4182,-192900
10,21/01/2014,22.1 (9.95 %),241,1133700,4704,219,757900,3461,375800
11,20/01/2014,20.1 (-2.43 %),163,665800,4085,212,695800,3282,-30000
12,17/01/2014,20.6 (-1.44 %),242,1064900,4400,242,975600,4031,89300
13,16/01/2014,20.9 (0.97 %),197,880200,4468,228,917200,4023,-37000
14,15/01/2014,20.7 (6.70 %),293,1339700,4572,280,1198600,4281,141100
15,14/01/2014,19.4 (4.30 %),318,1546500,4863,266,1401300,5268,145200
16,13/01/2014,18.6 (0.00 %),154,611200,3969,155,620600,4004,-9400
17,10/01/2014,18.6 (-1.06 %),114,530000,4649,142,739100,5205,-209100
18,09/01/2014,18.8 (3.87 %),234,1107700,4734,242,949600,3924,158100
19,08/01/2014,18.1 (-0.55 %),89,379900,4269,118,503900,4270,-124000
20,07/01/2014,18.2 (1.11 %),74,340500,4601,191,576800,3020,-236300
1,06/01/2014,18 (2.86 %),75,354100,4721,164,378400,2307,-24300
2,03/01/2014,17.5 (-0.57 %),49,186300,3802,69,159700,2314,26600
3,02/01/2014,17.6 (-0.56 %),56,158600,2832,83,270200,3255,-111600
4,31/12/2013,17.7 (3.51 %),103,431000,4184,77,324200,4210,106800
5,30/12/2013,17.1 (-3.39 %),104,336700,3238,96,402300,4191,-65600
6,27/12/2013,17.7 (0.00 %),95,267700,2818,72,254400,3533,13300
7,26/12/2013,17.7 (-2.21 %),134,354600,2646,96,402300,4191,-47700
8,25/12/2013,18.1 (0.00 %),78,242600,3110,90,313000,3478,-70400
9,24/12/2013,18.1 (0.00 %),101,365800,3622,103,373000,3621,-7200
10,23/12/2013,18.1 (0.56 %),75,341900,4559,122,459200,3764,-117300
11,20/12/2013,18 (-1.10 %),88,347200,3945,119,432000,3630,-84800
12,19/12/2013,18.2 (2.25 %),153,714200,4668,236,750200,3179,-36000
13,18/12/2013,17.8 (0.00 %),88,320000,3636,121,437000,3612,-117000
14,17/12/2013,17.8 (1.71 %),107,520400,4864,124,413300,3333,107100
15,16/12/2013,17.5 (0.57 %),101,315100,3120,80,237500,2969,77600
16,13/12/2013,17.4 (0.58 %),88,281400,3198,83,184700,2225,96700
17,12/12/2013,17.3 (0.58 %),175,656200,3750,90,479300,5326,176900
18,11/12/2013,17.2 (-2.82 %),96,287200,2992,83,284800,3431,2400
19,10/12/2013,17.7 (-0.56 %),164,567300,3459,109,449800,4127,117500
20,09/12/2013,17.8 (-1.66 %),191,790600,4139,171,1003100,5866,-212500
1,06/12/2013,18.1 (0.56 %),151,444100,2941,135,391300,2899,52800
2,05/12/2013,18 (-0.55 %),153,595300,3891,140,675100,4822,-79800
3,04/12/2013,18.1 (3.43 %),227,1190900,5246,233,994700,4269,196200
4,03/12/2013,17.5 (3.55 %),234,1203900,5145,282,1246900,4422,-43000
5,02/12/2013,16.9 (0.00 %),98,433000,4418,106,413400,3900,19600
6,29/11/2013,16.9 (-0.59 %),103,480400,4664,127,558600,4398,-78200
7,28/11/2013,17 (0.59 %),69,239100,3465,87,265500,3052,-26400
8,27/11/2013,16.9 (0.00 %),129,653700,5067,130,697100,5362,-43400
9,26/11/2013,16.9 (0.00 %),178,746400,4193,97,545200,5621,201200
10,25/11/2013,16.9 (-1.17 %),176,733800,4169,145,793600,5473,-59800
11,22/11/2013,17.1 (0.59 %),177,715900,4045,162,606300,3743,109600
12,21/11/2013,17 (0.00 %),224,1207300,5390,330,1187900,3600,19400
13,20/11/2013,17 (0.59 %),153,807000,5275,149,647000,4342,160000
14,19/11/2013,16.9 (3.05 %),336,1620900,4824,295,1259600,4270,361300
15,18/11/2013,16.4 (3.14 %),250,1193700,4775,310,1312800,4235,-119100
16,15/11/2013,15.9 (0.63 %),128,474000,3703,95,394700,4155,79300
17,14/11/2013,15.8 (-0.63 %),152,411500,2707,106,644400,6079,-232900
18,13/11/2013,15.9 (-0.62 %),128,522500,4082,120,588300,4903,-65800
19,12/11/2013,16 (-2.44 %),145,477200,3291,176,981000,5574,-503800
20,11/11/2013,16.4 (3.14 %),145,905600,6246,161,682300,4238,223300
1,08/11/2013,15.9 (-0.62 %),92,330000,3587,106,431800,4074,-101800
2,07/11/2013,16 (0.63 %),157,764100,4867,202,920700,4558,-156600
3,06/11/2013,15.9 (0.63 %),143,605800,4236,113,505200,4471,100600
4,05/11/2013,15.8 (-0.63 %),182,686300,3771,163,807200,4952,-120900
5,04/11/2013,15.9 (2.58 %),136,660700,4858,113,548000,4850,112700
6,01/11/2013,15.5 (-0.64 %),105,384600,3663,111,482300,4345,-97700
7,31/10/2013,15.6 (0.00 %),113,454600,4023,108,417200,3863,37400
8,30/10/2013,15.6 (-1.27 %),161,433800,2694,159,571100,3592,-137300
9,29/10/2013,15.8 (1.94 %),190,731600,3851,143,595100,4162,136500
10,28/10/2013,15.5 (-4.32 %),189,909600,4813,197,1023800,5197,-114200
11,25/10/2013,16.2 (-1.82 %),188,661000,3516,167,771100,4617,-110100
12,24/10/2013,16.5 (0.00 %),266,940700,3536,150,798200,5321,142500
13,23/10/2013,16.5 (2.48 %),257,1068300,4157,188,944000,5021,124300
14,22/10/2013,16.1 (-1.23 %),283,1105600,3907,198,934700,4721,170900
15,21/10/2013,16.3 (-1.21 %),282,803600,2850,271,951800,3512,-148200
16,18/10/2013,16.5 (2.48 %),207,1191000,5754,299,1166800,3902,24200
17,17/10/2013,16.1 (2.55 %),265,1244900,4698,306,1280500,4185,-35600
18,16/10/2013,15.7 (0.64 %),147,609700,4148,255,914800,3587,-305100
19,15/10/2013,15.6 (2.63 %),188,751000,3995,199,713800,3587,37200
20,14/10/2013,15.2 (-2.56 %),157,562400,3582,152,570400,3753,-8000
1,11/10/2013,15.6 (-0.64 %),159,543300,3417,181,720700,3982,-177400
2,10/10/2013,15.7 (3.29 %),355,1797800,5064,411,1912500,4653,-114700
3,09/10/2013,15.2 (-0.65 %),203,887100,4370,168,967800,5761,-80700
4,08/10/2013,15.3 (-1.29 %),197,897600,4556,218,990100,4542,-92500
5,07/10/2013,15.5 (5.44 %),300,1446000,4820,317,1189400,3752,256600
6,04/10/2013,14.7 (0.00 %),133,753300,5664,180,632300,3513,121000
7,03/10/2013,14.7 (0.68 %),237,1275600,5382,272,1091800,4014,183800
8,02/10/2013,14.6 (2.82 %),249,1316200,5286,355,1488900,4194,-172700
9,01/10/2013,14.2 (4.41 %),258,1348200,5226,417,1467600,3519,-119400
10,30/09/2013,13.6 (0.74 %),114,423400,3714,120,431500,3596,-8100
11,27/09/2013,13.5 (-1.46 %),145,528800,3647,134,613700,4580,-84900
12,26/09/2013,13.7 (2.24 %),237,884400,3732,284,998600,3516,-114200
13,25/09/2013,13.4 (1.52 %),146,622300,4262,144,607100,4216,15200
14,24/09/2013,13.2 (0.76 %),114,338500,2969,86,273400,3179,65100
15,23/09/2013,13.1 (0.77 %),89,311100,3496,69,278800,4041,32300
16,20/09/2013,13 (0.00 %),68,163400,2403,48,158000,3292,5400
17,19/09/2013,13 (0.78 %),82,276700,3374,57,232300,4075,44400
18,18/09/2013,12.9 (0.00 %),123,347500,2825,76,358700,4720,-11200
19,17/09/2013,12.9 (-0.77 %),81,289100,3569,44,174800,3973,114300
20,16/09/2013,13 (-0.76 %),65,152600,2348,50,149000,2980,3600
1,13/09/2013,13.1 (-0.76 %),105,275300,2622,79,273500,3462,1800
2,12/09/2013,13.2 (1.54 %),98,181400,1851,64,124600,1947,56800
3,11/09/2013,13 (0.00 %),70,184800,2640,43,155100,3607,29700
4,10/09/2013,13 (0.78 %),76,261000,3434,43,202200,4702,58800
5,09/09/2013,12.9 (-2.27 %),102,181100,1775,61,173100,2838,8000
6,06/09/2013,13.2 (0.00 %),61,130400,2138,71,144400,2034,-14000
7,05/09/2013,13.2 (0.00 %),63,123300,1957,50,112600,2252,10700
8,04/09/2013,13.2 (-0.75 %),42,88400,2105,45,114800,2551,-26400
9,03/09/2013,13.3 (-0.75 %),42,77300,1840,47,116700,2483,-39400
10,30/08/2013,13.4 (1.52 %),70,163300,2333,55,167300,3042,-4000
11,29/08/2013,13.2 (-0.75 %),88,120900,1374,55,133600,2429,-12700
12,28/08/2013,13.3 (-1.48 %),104,283200,2723,91,280800,3086,2400
13,27/08/2013,13.5 (-0.74 %),50,147400,2948,76,160500,2112,-13100
14,26/08/2013,13.6 (0.74 %),116,246600,2126,74,213500,2885,33100
15,23/08/2013,13.5 (0.00 %),114,271500,2382,101,280300,2775,-8800
16,22/08/2013,13.5 (-1.46 %),98,284700,2905,102,299200,2933,-14500
17,21/08/2013,13.7 (0.74 %),131,435400,3324,75,342700,4569,92700
18,20/08/2013,13.6 (-0.73 %),108,308000,2852,113,324000,2867,-16000
19,19/08/2013,13.7 (2.24 %),121,473900,3917,186,426400,2292,47500
20,16/08/2013,13.4 (0.00 %),83,223700,2695,86,238300,2771,-14600
1,15/08/2013,13.4 (0.75 %),99,319300,3225,81,281800,3479,37500
2,14/08/2013,13.3 (0.00 %),112,371700,3319,63,313200,4971,58500
3,13/08/2013,13.3 (-0.75 %),82,244900,2987,75,307900,4105,-63000
4,12/08/2013,13.4 (0.00 %),74,238600,3224,78,221900,2845,16700
5,09/08/2013,13.4 (0.75 %),124,345200,2784,115,343700,2989,1500
6,08/08/2013,13.3 (0.00 %),95,394000,4147,83,394400,4752,-400
7,07/08/2013,13.3 (0.00 %),72,234400,3256,85,256600,3019,-22200
8,06/08/2013,13.3 (0.00 %),93,301200,3239,82,232800,2839,68400
9,05/08/2013,13.3 (-0.75 %),61,155400,2548,58,185200,3193,-29800
10,02/08/2013,13.4 (0.00 %),53,97500,1840,53,108700,2051,-11200
11,01/08/2013,13.4 (0.75 %),65,146500,2254,47,114000,2426,32500
12,31/07/2013,13.3 (0.76 %),70,152600,2180,49,76000,1551,76600
13,30/07/2013,13.2 (0.76 %),78,181400,2326,51,129800,2545,51600
14,29/07/2013,13.1 (-1.50 %),103,153500,1490,62,176100,2840,-22600
15,26/07/2013,13.3 (-0.75 %),112,179200,1600,58,211100,3640,-31900
16,25/07/2013,13.4 (0.00 %),125,272400,2179,76,204700,2693,67700
17,24/07/2013,13.4 (-2.90 %),152,247700,1630,105,327200,3116,-79500
18,23/07/2013,13.8 (0.00 %),108,137300,1271,96,185600,1933,-48300
19,22/07/2013,13.8 (-0.72 %),75,137700,1836,130,204100,1570,-66400
20,19/07/2013,13.7 (0.74 %),106,373500,3524,155,377300,2434,-3800
1,18/07/2013,13.6 (0.00 %),111,388200,3497,121,337600,2790,50600
2,17/07/2013,13.6 (0.74 %),86,136600,1588,74,192000,2595,-55400
3,16/07/2013,13.5 (-0.74 %),79,218000,2759,83,248800,2998,-30800
4,15/07/2013,13.6 (0.74 %),129,273800,2122,120,270200,2252,3600
5,12/07/2013,13.5 (2.27 %),135,370900,2747,108,188500,1745,182400
6,11/07/2013,13.2 (-0.75 %),90,190100,2112,65,172200,2649,17900
7,10/07/2013,13.3 (0.76 %),99,187700,1896,86,173900,2022,13800
8,09/07/2013,13.2 (0.00 %),111,212800,1917,79,150800,1909,62000
9,08/07/2013,13.2 (1.54 %),134,315200,2352,63,140400,2229,174800
10,05/07/2013,13 (-2.26 %),189,372400,1970,82,318000,3878,54400
11,04/07/2013,13.3 (-0.75 %),131,56,0,168100,150300,1,-150244
12,03/07/2013,13.4 (-0.74 %),101,135000,1337,93,167700,1803,-32700
13,02/07/2013,13.5 (1.50 %),108,260300,2410,93,213300,2294,47000
14,01/07/2013,13.3 (0.00 %),92,154300,1677,59,106900,1812,47400
15,28/06/2013,13.3 (-0.75 %),128,249200,1947,115,323400,2812,-74200
16,27/06/2013,13.4 (1.52 %),124,285300,2301,76,220100,2896,65200
17,26/06/2013,13.3 (1.53 %),116,247600,2134,71,166400,2344,81200
18,25/06/2013,13.3 (-2.21 %),284,527200,1856,122,465700,3817,61500
19,24/06/2013,13.6 (-0.73 %),104,209600,2015,78,210800,2703,-1200
20,21/06/2013,13.7 (0.00 %),162,368000,2272,87,258600,2972,109400
1,20/06/2013,13.7 (-0.72 %),145,277100,1911,81,240800,2973,36300
2,19/06/2013,13.8 (-0.72 %),147,326100,2218,100,273900,2739,52200
3,18/06/2013,13.9 (0.00 %),156,316900,2031,84,236100,2811,80800
4,17/06/2013,13.9 (-3.47 %),195,553800,2840,128,627800,4905,-74000
5,14/06/2013,14.4 (-0.69 %),124,435200,3510,178,601700,3380,-166500
6,13/06/2013,14.5 (0.69 %),210,626500,2983,212,605500,2856,21000
7,12/06/2013,15.4 (0.00 %),179,566600,3165,200,655800,3279,-89200
8,11/06/2013,15.4 (0.00 %),140,424200,3030,191,534700,2799,-110500
9,10/06/2013,15.4 (0.65 %),215,707800,3292,243,744600,3064,-36800
10,07/06/2013,15.5 (1.31 %),218,808600,3709,238,867100,3643,-58500
11,06/06/2013,15.3 (-0.65 %),192,619100,3224,213,757000,3554,-137900
12,05/06/2013,15.4 (2.67 %),269,742700,2761,225,620900,2760,121800
13,04/06/2013,15.1 (-2.58 %),294,767500,2611,244,821500,3367,-54000
14,03/06/2013,15.5 (-0.64 %),250,771800,3087,244,751000,3078,20800
15,31/05/2013,15.6 (0.65 %),289,930400,3219,404,1076300,2664,-145900
16,30/05/2013,15.6 (4.00 %),370,1487700,4021,427,1205100,2822,282600
17,29/05/2013,15 (2.04 %),523,2119600,4053,589,2233400,3792,-113800
18,28/05/2013,14.7 (0.68 %),223,723600,3245,250,820800,3283,-97200
19,27/05/2013,14.6 (2.10 %),269,986200,3666,336,1120700,3335,-134500
20,24/05/2013,14.4 (0.70 %),161,450400,2798,187,645200,3450,-194800
1,23/05/2013,14.3 (-1.38 %),145,497200,3429,278,742300,2670,-245100
2,22/05/2013,14.5 (2.11 %),182,748700,4114,412,1141200,2770,-392500
3,21/05/2013,14.2 (0.71 %),217,528600,2436,281,751600,2675,-223000
4,20/05/2013,14.1 (0.71 %),168,267900,1595,202,378500,1874,-110600
5,17/05/2013,14 (0.72 %),150,518000,3453,266,504500,1897,13500
6,16/05/2013,13.9 (1.46 %),131,342800,2617,155,305500,1971,37300
7,15/05/2013,13.7 (0.00 %),178,302000,1697,103,285800,2775,16200
8,14/05/2013,13.6 (-2.16 %),153,293200,1916,139,303700,2185,-10500
9,13/05/2013,13.9 (0.72 %),163,341900,2098,123,340800,2771,1100
10,10/05/2013,13.9 (0.00 %),192,374300,1949,129,382600,2966,-8300
11,09/05/2013,13.9 (0.72 %),172,380800,2214,155,365300,2357,15500
12,08/05/2013,13.8 (0.00 %),111,253000,2279,103,317900,3086,-64900
13,07/05/2013,13.8 (-2.13 %),175,563300,3219,186,489100,2630,74200
14,06/05/2013,14.1 (1.44 %),163,440900,2705,203,481000,2369,-40100
15,03/05/2013,13.8 (2.22 %),152,531100,3494,180,446900,2483,84200
16,02/05/2013,13.5 (0.00 %),93,181600,1953,66,191200,2897,-9600
17,26/04/2013,13.6 (0.00 %),90,150300,1670,89,234100,2630,-83800
18,25/04/2013,13.7 (1.48 %),129,436500,3384,103,251100,2438,185400
19,24/04/2013,13.5 (0.00 %),106,257900,2433,86,201900,2348,56000
20,23/04/2013,13.5 (0.75 %),137,342800,2502,92,273100,2968,69700
1,22/04/2013,13.4 (-1.47 %),112,283300,2529,107,359000,3355,-75700
2,18/04/2013,13.6 (-2.16 %),98,263000,2684,134,403900,3014,-140900
3,17/04/2013,13.9 (1.46 %),93,272000,2925,106,278000,2623,-6000
4,16/04/2013,13.7 (0.74 %),204,821900,4029,152,447000,2941,374900
5,15/04/2013,13.6 (-2.86 %),207,471300,2277,140,540000,3857,-68700
6,12/04/2013,14 (-2.78 %),193,446500,2313,207,645100,3116,-198600
7,11/04/2013,14.4 (0.70 %),181,402200,2222,156,420200,2694,-18000
8,10/04/2013,14.3 (-4.03 %),227,600700,2646,347,844200,2433,-243500
9,09/04/2013,14.9 (3.47 %),398,1260200,3166,457,1289200,2821,-29000
10,08/04/2013,14.4 (2.86 %),257,1085800,4225,325,776300,2389,309500
11,05/04/2013,14 (2.94 %),187,701400,3751,220,679600,3089,21800
12,04/04/2013,13.7 (0.00 %),112,218500,1951,96,260100,2709,-41600
13,03/04/2013,13.7 (0.00 %),140,325000,2321,149,436600,2930,-111600
14,02/04/2013,13.7 (-1.44 %),143,247400,1730,222,649900,2927,-402500
15,01/04/2013,13.9 (3.73 %),154,319100,2072,153,250700,1639,68400
16,29/03/2013,13.4 (-0.74 %),171,376900,2204,119,259300,2179,117600
17,28/03/2013,13.5 (-0.74 %),135,308700,2287,126,328700,2609,-20000
18,27/03/2013,13.7 (0.00 %),132,237000,1795,128,223500,1746,13500
19,26/03/2013,13.7 (0.00 %),154,294400,1912,133,381000,2865,-86600
20,25/03/2013,13.8 (0.73 %),152,494600,3254,129,368500,2857,126100
1,22/03/2013,13.7 (-1.44 %),189,352700,1866,146,541600,3710,-188900
2,21/03/2013,13.9 (0.72 %),140,448000,3200,180,485200,2696,-37200
3,20/03/2013,13.8 (0.73 %),132,276100,2092,127,313300,2467,-37200
4,19/03/2013,13.8 (0.00 %),116,178900,1542,94,227200,2417,-48300
5,18/03/2013,13.8 (-0.72 %),134,275500,2056,124,335600,2706,-60100
6,15/03/2013,13.9 (0.72 %),179,376200,2102,157,430300,2741,-54100
7,14/03/2013,13.8 (0.00 %),127,198500,1563,115,295000,2565,-96500
8,13/03/2013,13.8 (-1.43 %),208,360000,1731,147,446400,3037,-86400
9,12/03/2013,14 (-1.41 %),154,357700,2323,232,532900,2297,-175200
10,11/03/2013,14.2 (2.16 %),190,487700,2567,238,531500,2233,-43800
11,08/03/2013,13.9 (2.21 %),143,279400,1954,128,200300,1565,79100
12,07/03/2013,13.6 (-2.16 %),188,325500,1731,158,360200,2280,-34700
13,06/03/2013,13.8 (1.47 %),194,471000,2428,152,377700,2485,93300
14,05/03/2013,13.6 (-1.45 %),202,399500,1978,210,414200,1972,-14700
15,04/03/2013,13.8 (-4.17 %),267,789700,2958,220,1052600,4785,-262900
16,01/03/2013,14.4 (-0.69 %),187,603800,3229,204,619200,3035,-15400
17,28/02/2013,14.4 (0.70 %),214,710300,3319,295,789200,2675,-78900
18,27/02/2013,14.3 (0.00 %),258,485300,1881,232,604800,2607,-119500
19,26/02/2013,14.3 (-4.03 %),335,865500,2584,373,1118300,2998,-252800
20,25/02/2013,14.9 (2.76 %),256,700600,2737,212,674500,3182,26100
1,22/02/2013,14.5 (0.69 %),524,1270700,2425,397,1146800,2889,123900
2,21/02/2013,14.3 (-9.49 %),511,1277500,2500,377,1602500,4251,-325000
3,20/02/2013,15.8 (0.64 %),344,1371500,3987,399,1524200,3820,-152700
4,19/02/2013,15.9 (6.00 %),572,2435900,4259,493,2343500,4754,92400
5,18/02/2013,15 (3.45 %),314,1107600,3527,344,1059400,3080,48200
6,08/02/2013,14.6 (0.00 %),372,1085700,2919,170,957800,5634,127900
7,07/02/2013,14.5 (0.00 %),156,557000,3571,236,595500,2523,-38500
8,06/02/2013,14.5 (2.11 %),139,528500,3802,135,400100,2964,128400
9,05/02/2013,14.2 (-0.70 %),123,295000,2398,135,341500,2530,-46500
10,04/02/2013,14.4 (-0.69 %),169,590900,3496,172,575800,3348,15100
11,01/02/2013,14.5 (1.40 %),234,555900,2376,198,445000,2247,110900
12,31/01/2013,14.3 (-2.72 %),204,446300,2188,222,490300,2209,-44000
13,30/01/2013,14.7 (0.00 %),158,516800,3271,285,696100,2442,-179300
14,29/01/2013,14.7 (3.52 %),251,891400,3551,298,808900,2714,82500
15,28/01/2013,14.2 (0.71 %),249,793400,3186,356,1079400,3032,-286000
16,25/01/2013,14.1 (0.71 %),182,406300,2232,255,691300,2711,-285000
17,24/01/2013,14 (2.94 %),158,311300,1970,168,335700,1998,-24400
18,23/01/2013,13.6 (-1.45 %),207,347800,1680,173,458700,2651,-110900
19,22/01/2013,13.7 (-3.52 %),211,561400,2661,199,607700,3054,-46300
20,21/01/2013,14.2 (0.00 %),169,561400,3322,213,566400,2659,-5000
1,18/01/2013,14.2 (-2.74 %),313,769900,2460,267,871400,3264,-101500
2,17/01/2013,14.6 (-1.35 %),228,618600,2713,266,826800,3108,-208200
3,16/01/2013,14.8 (0.00 %),340,944500,2778,393,1332700,3391,-388200
4,15/01/2013,14.8 (2.07 %),314,740000,2357,267,816600,3058,-76600
5,14/01/2013,14.5 (-1.36 %),264,480500,1820,257,638300,2484,-157800
6,11/01/2013,14.7 (-0.68 %),246,565200,2298,350,912500,2607,-347300
7,10/01/2013,14.8 (2.78 %),273,671200,2459,294,703900,2394,-32700
8,09/01/2013,14.4 (1.41 %),557,1549900,2783,547,1582200,2893,-32300
9,08/01/2013,14.2 (0.00 %),212,705000,3325,264,742000,2811,-37000
10,07/01/2013,14.2 (-1.39 %),288,847300,2942,327,1163500,3558,-316200
11,04/01/2013,14.3 (1.42 %),237,733700,3096,257,710900,2766,22800
12,03/01/2013,14.1 (-2.76 %),310,1001800,3232,422,1137100,2695,-135300
13,02/01/2013,14.5 (5.07 %),327,1002300,3065,392,1095700,2795,-93400
14,28/12/2012,13.9 (2.96 %),258,690000,2674,257,599900,2334,90100
15,27/12/2012,13.6 (0.00 %),333,859600,2581,416,1171900,2817,-312300
16,26/12/2012,13.7 (2.24 %),221,494800,2239,228,580800,2547,-86000
17,25/12/2012,13.3 (-2.21 %),178,421600,2369,251,672500,2679,-250900
18,24/12/2012,13.7 (4.58 %),240,665800,2774,283,772200,2729,-106400
19,21/12/2012,13.1 (0.00 %),159,281500,1770,148,294100,1987,-12600
20,20/12/2012,13.1 (-1.50 %),184,368300,2002,188,435600,2317,-67300
1,19/12/2012,13.3 (1.53 %),300,556600,1855,184,510300,2773,46300
2,18/12/2012,13.1 (-2.24 %),282,522300,1852,178,546300,3069,-24000
3,17/12/2012,13.3 (-1.48 %),191,354000,1853,178,389500,2188,-35500
4,14/12/2012,13.5 (-1.46 %),157,442900,2821,213,590900,2774,-148000
5,13/12/2012,13.7 (1.48 %),283,600600,2122,305,750400,2460,-149800
6,12/12/2012,13.6 (2.26 %),212,399000,1882,183,390500,2134,8500
7,11/12/2012,13.3 (-1.48 %),153,315400,2061,212,474800,2240,-159400
8,10/12/2012,13.5 (3.05 %),206,491900,2388,211,523800,2482,-31900
9,07/12/2012,13.1 (-0.76 %),146,265800,1821,156,299500,1920,-33700
10,06/12/2012,13.2 (-0.75 %),161,277100,1721,168,283700,1689,-6600
11,05/12/2012,13.3 (0.00 %),200,536100,2681,313,653500,2088,-117400
12,04/12/2012,13.3 (3.10 %),284,728500,2565,312,729000,2337,-500
13,03/12/2012,13 (0.78 %),144,348200,2418,124,197600,1594,150600
14,30/11/2012,12.9 (-1.53 %),177,348300,1968,241,368200,1528,-19900
15,29/11/2012,13.1 (4.80 %),492,1262900,2567,413,1131600,2740,131300
16,28/11/2012,12.6 (0.80 %),170,449800,2646,153,415000,2712,34800
17,27/11/2012,12.6 (2.44 %),182,297300,1634,165,324700,1968,-27400
18,26/11/2012,12.3 (-0.81 %),108,283300,2623,123,275900,2243,7400
19,23/11/2012,12.4 (-0.80 %),100,185400,1854,110,210800,1916,-25400
20,22/11/2012,12.5 (0.81 %),111,237300,2138,104,219200,2108,18100
1,21/11/2012,12.4 (-0.80 %),161,328200,2039,114,253100,2220,75100
2,20/11/2012,12.5 (0.00 %),202,503700,2494,151,411800,2727,91900
3,19/11/2012,12.5 (-0.79 %),115,257900,2243,97,190200,1961,67700
4,16/11/2012,12.6 (0.80 %),147,529900,3605,113,236400,2092,293500
5,15/11/2012,12.5 (-0.79 %),210,462400,2202,152,381900,2513,80500
6,14/11/2012,12.6 (-0.79 %),163,441300,2707,147,352100,2395,89200
7,13/11/2012,12.7 (-2.31 %),132,184000,1394,207,265100,1281,-81100
8,12/11/2012,13 (4.00 %),293,984500,3360,275,629700,2290,354800
9,09/11/2012,12.5 (0.00 %),220,565400,2570,196,520600,2656,44800
10,08/11/2012,12.6 (0.00 %),154,350200,2274,161,275200,1709,75000
11,07/11/2012,12.6 (2.44 %),137,241900,1766,144,187400,1301,54500
12,06/11/2012,12.3 (0.00 %),169,424800,2514,120,312200,2602,112600
13,05/11/2012,12.3 (0.00 %),157,329800,2101,87,112500,1293,217300
14,02/11/2012,12.2 (-4.69 %),280,696000,2486,259,603500,2330,92500
15,01/11/2012,12.8 (1.59 %),153,374400,2447,146,234300,1605,140100
16,31/10/2012,12.6 (-0.79 %),235,434300,1848,134,324900,2425,109400
17,30/10/2012,12.8 (-0.78 %),180,367600,2042,135,397300,2943,-29700
18,29/10/2012,12.9 (0.00 %),125,247700,1982,106,199600,1883,48100
19,26/10/2012,12.9 (-0.77 %),203,455900,2246,143,379600,2655,76300
20,25/10/2012,12.9 (-1.53 %),187,417700,2234,178,411800,2313,5900
1,24/10/2012,13.1 (-1.50 %),149,281900,1892,215,314400,1462,-32500
2,23/10/2012,13.4 (5.51 %),340,825600,2428,156,362800,2326,462800
3,22/10/2012,12.8 (-3.03 %),368,705900,1918,203,710000,3498,-4100
4,19/10/2012,13.3 (-2.92 %),361,679200,1881,264,627700,2378,51500
5,18/10/2012,13.7 (-1.44 %),351,578600,1648,265,690300,2605,-111700
6,17/10/2012,13.9 (-4.14 %),261,472500,1810,288,669100,2323,-196600
7,16/10/2012,14.6 (3.55 %),366,684900,1871,275,633400,2303,51500
8,15/10/2012,13.9 (-4.14 %),122,810900,6647,349,975100,2794,-164200
9,12/10/2012,14.5 (2.84 %),252,1274000,5056,412,936400,2273,337600
10,11/10/2012,14.2 (6.77 %),307,1087200,3541,270,653700,2421,433500
11,10/10/2012,13.5 (3.05 %),154,424500,2756,148,250100,1690,174400
12,09/10/2012,13.1 (-0.76 %),122,177500,1455,217,476300,2195,-298800
13,08/10/2012,13.3 (3.10 %),146,275000,1884,162,315700,1949,-40700
14,05/10/2012,12.9 (1.57 %),96,281500,2932,110,223300,2030,58200
15,04/10/2012,12.7 (-1.55 %),88,68300,776,117,160800,1374,-92500
16,03/10/2012,12.7 (0.79 %),141,156000,1106,162,210200,1298,-54200
17,02/10/2012,12.5 (-1.57 %),105,169600,1615,105,160000,1524,9600
18,01/10/2012,12.7 (-1.55 %),135,202600,1501,147,256500,1745,-53900
19,28/09/2012,12.9 (0.00 %),110,155100,1410,93,138200,1486,16900
20,27/09/2012,12.8 (-2.29 %),166,185200,1116,141,214500,1521,-29300
1,26/09/2012,13.1 (1.55 %),118,157700,1336,149,241000,1617,-83300
2,25/09/2012,13.1 (2.34 %),85,169600,1995,110,182900,1663,-13300
3,24/09/2012,12.8 (-3.03 %),111,151300,1363,142,227900,1605,-76600
4,21/09/2012,13.3 (1.53 %),114,171100,1501,182,252500,1387,-81400
5,20/09/2012,13.1 (-0.76 %),151,226700,1501,150,264800,1765,-38100
6,19/09/2012,13.3 (3.91 %),233,316500,1358,135,187100,1386,129400
7,18/09/2012,12.8 (-5.19 %),222,219600,989,179,254500,1422,-34900
8,17/09/2012,13.5 (-2.88 %),154,200400,1301,175,388700,2221,-188300
9,14/09/2012,13.9 (4.51 %),177,390300,2205,282,482100,1710,-91800
10,13/09/2012,13.4 (3.88 %),146,234200,1604,134,157700,1177,76500
11,12/09/2012,13 (1.56 %),135,170900,1266,135,187500,1389,-16600
12,11/09/2012,12.8 (0.79 %),222,276900,1247,126,146900,1166,130000
13,10/09/2012,12.9 (-4.44 %),216,376200,1742,194,414900,2139,-38700
14,07/09/2012,13.5 (-0.74 %),223,283900,1273,154,259900,1688,24000
15,06/09/2012,13.5 (-3.57 %),134,210800,1573,139,316200,2275,-105400
16,05/09/2012,14.1 (-2.76 %),174,217300,1249,183,291300,1592,-74000
17,04/09/2012,14.4 (2.86 %),194,263500,1358,177,297900,1683,-34400
18,31/08/2012,14.1 (2.92 %),234,231100,988,152,266600,1754,-35500
19,30/08/2012,15.4 (-0.65 %),176,306700,1743,242,419000,1731,-112300
20,29/08/2012,15.5 (6.90 %),264,377900,1431,176,230600,1310,147300
1,28/08/2012,14.5 (-5.23 %),235,263200,1120,171,308700,1805,-45500
2,27/08/2012,15.3 (-6.71 %),172,199600,1160,156,350900,2249,-151300
3,24/08/2012,16.3 (0.62 %),396,536900,1356,313,532900,1703,4000
4,23/08/2012,16.2 (-6.90 %),93,95600,1028,101,209300,2072,-113700
5,22/08/2012,17.5 (3.55 %),438,640500,1462,229,585700,2558,54800
6,21/08/2012,16.9 (-6.63 %),245,336500,1373,210,471000,2243,-134500
7,20/08/2012,18.1 (6.47 %),482,1246100,2585,332,819200,2467,426900
8,17/08/2012,17 (0.00 %),114,116300,1020,114,148400,1302,-32100
9,16/08/2012,17 (0.00 %),77,97500,1266,87,99200,1140,-1700
10,15/08/2012,17 (0.00 %),120,157400,1312,112,141600,1264,15800
11,14/08/2012,17 (0.00 %),122,129600,1062,111,118900,1071,10700
12,13/08/2012,17 (0.00 %),146,88700,608,124,139000,1121,-50300
13,10/08/2012,18.1 (-1.09 %),127,96000,756,110,245900,2235,-149900
14,09/08/2012,18.3 (1.10 %),105,142200,1354,165,218500,1324,-76300
15,08/08/2012,18.2 (2.25 %),130,125100,962,130,119600,920,5500
16,07/08/2012,17.9 (-2.72 %),121,139300,1151,139,247800,1783,-108500
17,06/08/2012,18.4 (3.37 %),107,142500,1332,172,193800,1127,-51300
18,03/08/2012,17.9 (0.56 %),56,82000,1464,66,84600,1282,-2600
19,02/08/2012,17.9 (0.56 %),75,82200,1096,124,122300,986,-40100
20,01/08/2012,17.8 (-0.56 %),114,143800,1261,102,132100,1295,11700
1,31/07/2012,17.9 (1.70 %),129,186600,1447,122,174900,1434,11700
2,30/07/2012,17.7 (0.00 %),82,101100,1233,78,115300,1478,-14200
3,27/07/2012,17.7 (0.00 %),96,148700,1549,118,124300,1053,24400
4,26/07/2012,17.6 (0.00 %),95,195000,2053,102,177100,1736,17900
5,25/07/2012,17.6 (0.00 %),121,227100,1877,86,169300,1969,57800
6,24/07/2012,17.5 (-3.31 %),213,416000,1953,120,322100,2684,93900
7,23/07/2012,18.3 (-1.61 %),101,145500,1441,133,190200,1430,-44700
8,20/07/2012,18.6 (-1.59 %),223,352800,1582,258,487300,1889,-134500
9,19/07/2012,18.9 (4.42 %),183,302500,1653,182,324100,1781,-21600
10,18/07/2012,18.2 (0.55 %),152,289800,1907,147,262100,1783,27700
11,17/07/2012,18.2 (3.41 %),134,162300,1211,126,165800,1316,-3500
12,16/07/2012,17.8 (-0.56 %),158,166100,1051,221,289000,1308,-122900
13,13/07/2012,17.8 (2.89 %),153,327200,2139,200,310400,1552,16800
14,12/07/2012,17.3 (1.76 %),121,260700,2155,165,212600,1288,48100
15,11/07/2012,16.9 (2.42 %),128,342000,2672,178,316300,1777,25700
16,10/07/2012,16.5 (0.61 %),143,220400,1541,137,147600,1077,72800
17,09/07/2012,16.5 (-2.94 %),142,191900,1351,237,224700,948,-32800
18,06/07/2012,17 (6.92 %),147,500500,3405,233,432200,1855,68300
19,05/07/2012,15.9 (6.71 %),224,376800,1682,135,196300,1454,180500
20,04/07/2012,14.8 (-5.73 %),174,216400,1244,124,255700,2062,-39300
1,03/07/2012,15.6 (-6.02 %),199,236400,1188,119,257200,2161,-20800
2,02/07/2012,16.6 (-2.35 %),94,99800,1062,91,136500,1500,-36700
3,29/06/2012,16.9 (-1.17 %),95,99600,1048,125,186500,1492,-86900
4,28/06/2012,17.3 (2.98 %),154,264700,1719,108,193600,1793,71100
5,27/06/2012,16.8 (-1.18 %),179,227500,1271,131,205000,1565,22500
6,26/06/2012,17.2 (-4.44 %),238,255500,1074,121,263400,2177,-7900
7,25/06/2012,18 (-4.26 %),195,227000,1164,121,241800,1998,-14800
8,22/06/2012,18.9 (-1.56 %),238,242200,1018,126,193900,1539,48300
9,21/06/2012,19.3 (-0.52 %),130,184800,1422,66,143000,2167,41800
10,20/06/2012,19.4 (0.00 %),108,101500,940,75,96900,1292,4600
11,19/06/2012,19.4 (-1.02 %),143,205700,1438,119,166700,1401,39000
12,18/06/2012,19.6 (0.51 %),152,189600,1247,106,246100,2322,-56500
13,15/06/2012,19.4 (0.00 %),196,260000,1327,99,200100,2021,59900
14,14/06/2012,19.4 (-2.51 %),225,327700,1456,102,163400,1602,164300
15,13/06/2012,19.9 (-1.00 %),261,326700,1252,170,241400,1420,85300
16,12/06/2012,20 (-4.76 %),292,367600,1259,273,420900,1542,-53300
17,11/06/2012,21.1 (2.43 %),163,282800,1735,256,293500,1146,-10700
18,08/06/2012,20.8 (1.46 %),209,373300,1786,330,454200,1376,-80900
19,07/06/2012,20.5 (6.77 %),185,413600,2236,181,282100,1559,131500
20,06/06/2012,19.6 (2.08 %),113,189100,1673,144,231300,1606,-42200
1,05/06/2012,19.1 (2.69 %),160,250500,1566,141,209400,1485,41100
2,04/06/2012,18.4 (-5.64 %),222,303700,1368,110,259500,2359,44200
3,01/06/2012,19.6 (1.03 %),150,184400,1229,80,135500,1694,48900
4,31/05/2012,19.4 (-4.90 %),188,274900,1462,125,294500,2356,-19600
5,30/05/2012,20.3 (-0.49 %),128,183500,1434,162,227000,1401,-43500
6,29/05/2012,20.3 (1.50 %),159,321200,2020,188,320600,1705,600
7,28/05/2012,19.8 (-1.49 %),176,208800,1186,138,230800,1672,-22000
8,25/05/2012,20.1 (6.91 %),150,246800,1645,82,130200,1588,116600
9,24/05/2012,19.2 (-0.52 %),209,325400,1557,149,317000,2128,8400
10,23/05/2012,19.3 (-6.76 %),221,299000,1353,166,430100,2591,-131100
11,22/05/2012,20.8 (-0.95 %),144,245400,1704,174,364900,2097,-119500
12,21/05/2012,21 (6.60 %),193,226800,1175,110,168600,1533,58200
13,18/05/2012,19.5 (-5.34 %),217,348200,1605,140,307600,2197,40600
14,17/05/2012,20.6 (-3.74 %),195,283600,1454,136,284500,2092,-900
15,16/05/2012,21.6 (3.35 %),309,483300,1564,142,286100,2015,197200
16,15/05/2012,20.8 (-3.26 %),257,413300,1608,146,337700,2313,75600
17,14/05/2012,21.5 (-6.93 %),326,470000,1442,186,532900,2865,-62900
18,11/05/2012,23.2 (-4.92 %),309,509800,1650,210,637500,3036,-127700
19,10/05/2012,24.2 (-2.81 %),228,554300,2431,239,704100,2946,-149800
20,09/05/2012,24.7 (-1.20 %),246,570100,2317,202,561300,2779,8800
1,08/05/2012,24.7 (-1.98 %),269,654800,2434,304,761400,2505,-106600
2,07/05/2012,25.3 (4.98 %),209,458200,2192,194,445900,2298,12300
3,04/05/2012,24 (0.84 %),175,329500,1883,259,439400,1697,-109900
4,03/05/2012,23.8 (-0.42 %),238,459300,1930,290,593200,2046,-133900
5,02/05/2012,23.9 (6.70 %),472,1496300,3170,296,1444400,4880,51900
6,27/04/2012,22.4 (6.67 %),212,671800,3169,134,227500,1698,444300
7,26/04/2012,21 (-2.78 %),135,227700,1687,154,264000,1714,-36300
8,25/04/2012,21.6 (3.35 %),218,422300,1937,245,442700,1807,-20400
9,24/04/2012,21 (1.94 %),155,208600,1346,116,176900,1525,31700
10,23/04/2012,20.6 (0.00 %),112,129100,1153,86,110800,1288,18300
11,20/04/2012,20.7 (0.98 %),168,187300,1115,91,146100,1605,41200
12,19/04/2012,20.3 (-5.58 %),245,365200,1491,186,379800,2042,-14600
13,18/04/2012,21.5 (-1.38 %),240,374700,1561,209,491600,2352,-116900
14,17/04/2012,21.6 (-0.92 %),248,479200,1932,225,572400,2544,-93200
15,16/04/2012,21.8 (3.32 %),227,395900,1744,232,426100,1837,-30200
16,13/04/2012,21.2 (-1.40 %),219,414400,1892,188,496700,2642,-82300
17,12/04/2012,21.4 (-0.93 %),159,360300,2266,239,511600,2141,-151300
18,11/04/2012,21.6 (4.35 %),192,446900,2328,191,450500,2359,-3600
19,10/04/2012,20.9 (-2.79 %),236,413000,1750,183,516700,2823,-103700
20,09/04/2012,21.3 (3.40 %),212,505500,2384,183,453200,2477,52300
1,06/04/2012,20.5 (-1.91 %),180,385300,2141,224,414300,1850,-29000
2,05/04/2012,20.9 (4.50 %),186,314300,1690,162,307500,1898,6800
3,04/04/2012,20 (-2.91 %),219,436400,1993,159,368400,2317,68000
4,03/04/2012,20.6 (6.74 %),173,428300,2476,120,134000,1117,294300
5,30/03/2012,20 (2.04 %),228,487000,2136,130,268500,2065,218500
6,29/03/2012,19.6 (-6.67 %),254,556300,2190,151,637600,4223,-81300
7,28/03/2012,21.2 (0.00 %),337,729400,2164,233,632000,2712,97400
8,27/03/2012,21.2 (-6.61 %),266,551000,2071,283,801100,2831,-250100
9,26/03/2012,22.7 (6.57 %),195,481700,2470,171,400000,2339,81700
10,23/03/2012,21.4 (7.00 %),203,802700,3954,153,473300,3093,329400
11,22/03/2012,20.3 (6.84 %),265,856900,3234,284,672400,2368,184500
12,21/03/2012,19.3 (6.63 %),203,1058800,5216,293,826800,2822,232000
13,20/03/2012,18 (0.00 %),168,427000,2542,199,510400,2565,-83400
14,19/03/2012,18.1 (-0.55 %),131,214800,1640,196,259600,1324,-44800
15,16/03/2012,18 (2.86 %),198,624100,3152,276,662100,2399,-38000
16,15/03/2012,18.1 (4.02 %),175,502300,2870,248,553300,2231,-51000
17,14/03/2012,17.2 (-2.27 %),130,221700,1705,142,249700,1758,-28000
18,13/03/2012,17.7 (-1.12 %),94,174200,1853,178,277900,1561,-103700
19,12/03/2012,17.9 (6.55 %),278,893400,3214,229,774700,3383,118700
20,09/03/2012,17.3 (1.76 %),218,467900,2146,133,292600,2200,175300
1,08/03/2012,16.6 (-6.74 %),221,499100,2258,208,594700,2859,-95600
2,07/03/2012,18 (-2.70 %),177,334100,1888,193,278500,1443,55600
3,06/03/2012,18.2 (-1.62 %),266,604100,2271,321,715800,2230,-111700
4,05/03/2012,18.5 (6.94 %),159,533800,3357,62,257900,4160,275900
5,02/03/2012,17.6 (6.67 %),188,766800,4079,206,462600,2246,304200
6,01/03/2012,16.5 (0.00 %),176,477500,2713,136,300300,2208,177200
7,29/02/2012,16.6 (0.00 %),181,414800,2292,142,246200,1734,168600
8,28/02/2012,16.4 (-4.09 %),196,425300,2170,208,411000,1976,14300
9,27/02/2012,17.4 (2.96 %),252,699400,2775,270,547000,2026,152400
10,24/02/2012,16.7 (3.09 %),165,512600,3107,285,476800,1673,35800
11,23/02/2012,16.5 (5.10 %),158,636500,4028,269,445500,1656,191000
12,22/02/2012,15.9 (1.92 %),185,353700,1912,231,398600,1726,-44900
13,21/02/2012,15.3 (2.00 %),245,656000,2678,363,718000,1978,-62000
14,20/02/2012,15 (6.38 %),92,521700,5671,123,293500,2386,228200
15,17/02/2012,14.1 (2.92 %),123,205300,1669,127,198900,1566,6400
16,16/02/2012,13.7 (0.74 %),117,199500,1705,88,151700,1724,47800
17,15/02/2012,13.7 (-1.44 %),114,171500,1504,121,159800,1321,11700
18,14/02/2012,13.9 (2.21 %),198,353000,1783,131,257100,1963,95900
19,13/02/2012,13.5 (-3.57 %),136,289500,2129,103,232200,2254,57300
20,10/02/2012,13.9 (-4.14 %),161,435400,2704,186,424300,2281,11100
1,09/02/2012,14.4 (2.13 %),249,585800,2353,286,621200,2172,-35400
2,08/02/2012,14.3 (6.72 %),251,713000,2841,197,533900,2710,179100
3,07/02/2012,13.6 (3.82 %),202,333300,1650,135,273600,2027,59700
4,06/02/2012,13.1 (-3.68 %),195,363000,1862,94,286300,3046,76700
5,03/02/2012,13.5 (-4.26 %),195,279600,1434,171,357600,2091,-78000
6,02/02/2012,14.2 (6.77 %),134,225900,1686,102,132000,1294,93900
7,01/02/2012,13.5 (0.75 %),77,122200,1587,115,126700,1102,-4500
8,31/01/2012,13.2 (3.94 %),120,415300,3461,149,346000,2322,69300
9,30/01/2012,12.8 (0.00 %),59,87700,1486,64,110000,1719,-22300
10,20/01/2012,12.6 (-1.56 %),69,81300,1178,66,91100,1380,-9800
11,19/01/2012,12.8 (4.92 %),84,110800,1319,82,82100,1001,28700
12,18/01/2012,12.3 (1.65 %),67,93200,1391,56,73300,1309,19900
13,17/01/2012,12.1 (-2.42 %),63,74000,1175,81,82100,1014,-8100
14,16/01/2012,12.3 (2.50 %),85,142300,1674,103,160000,1553,-17700
15,13/01/2012,12 (0.84 %),64,133000,2078,74,161000,2176,-28000
16,12/01/2012,11.9 (-2.46 %),64,100300,1567,72,130300,1810,-30000
17,11/01/2012,12 (0.00 %),69,119800,1736,114,182200,1598,-62400
18,10/01/2012,12.2 (6.09 %),99,203400,2055,97,134000,1381,69400
19,09/01/2012,11.6 (1.75 %),71,153000,2155,77,107200,1392,45800
20,06/01/2012,11.4 (-0.87 %),58,74400,1283,56,69900,1248,4500
1,05/01/2012,11.6 (0.00 %),78,84000,1077,76,97500,1283,-13500
2,04/01/2012,11.7 (1.74 %),98,169100,1726,133,144900,1089,24200
3,03/01/2012,11.5 (1.77 %),82,125900,1535,83,100900,1216,25000
4,30/12/2011,11.3 (3.67 %),110,163600,1487,85,94600,1113,69000
5,29/12/2011,10.9 (0.00 %),84,132800,1581,100,86700,867,46100
6,28/12/2011,11.2 (6.67 %),140,224200,1601,80,108500,1356,115700
7,27/12/2011,10.5 (-3.67 %),128,180700,1412,76,119900,1578,60800
8,26/12/2011,10.8 (-2.70 %),81,98400,1215,60,120500,2008,-22100
9,23/12/2011,11.2 (-3.45 %),140,210800,1506,76,172800,2274,38000
10,22/12/2011,11.4 (-4.20 %),170,193000,1135,86,213300,2480,-20300
11,21/12/2011,12 (0.84 %),112,148900,1329,64,97600,1525,51300
12,20/12/2011,11.9 (-4.03 %),123,200200,1628,78,195800,2510,4400
13,19/12/2011,12.3 (-0.81 %),95,126000,1326,70,128300,1833,-2300
14,16/12/2011,12.5 (5.04 %),160,219800,1374,89,139200,1564,80600
15,15/12/2011,12 (-3.23 %),156,340600,2183,113,249000,2204,91600
16,14/12/2011,12.5 (-3.10 %),146,449700,3080,71,218200,3073,231500
17,13/12/2011,12.7 (-3.79 %),130,226700,1744,78,212200,2721,14500
18,12/12/2011,13.2 (-2.22 %),109,142200,1305,93,106300,1143,35900
19,09/12/2011,13.5 (-2.88 %),98,192500,1964,92,140600,1528,51900
20,08/12/2011,13.8 (-1.43 %),87,138200,1589,85,106100,1248,32100
1,07/12/2011,14 (-0.71 %),102,211300,2072,94,180200,1917,31100
2,06/12/2011,13.9 (-1.42 %),102,251400,2465,175,287200,1641,-35800
3,05/12/2011,14.2 (6.77 %),197,504400,2560,83,222900,2686,281500
4,02/12/2011,13.5 (-0.74 %),181,351500,1942,109,212000,1945,139500
5,01/12/2011,13.5 (0.00 %),100,152900,1529,108,170600,1580,-17700
6,30/11/2011,13.4 (-2.19 %),78,120300,1542,82,117100,1428,3200
7,29/11/2011,13.6 (-0.73 %),73,188700,2585,113,181500,1606,7200
8,28/11/2011,13.5 (2.27 %),121,214800,1775,97,198000,2041,16800
9,25/11/2011,13.3 (0.00 %),102,268800,2635,86,152800,1777,116000
10,24/11/2011,13.1 (-2.24 %),117,241900,2068,128,215000,1680,26900
11,23/11/2011,13.4 (3.08 %),178,392700,2206,99,255700,2583,137000
12,22/11/2011,13.1 (0.00 %),118,254800,2159,105,182200,1735,72600
13,21/11/2011,13 (-1.52 %),110,212900,1935,75,153000,2040,59900
14,18/11/2011,13.1 (-4.38 %),144,236400,1642,93,221100,2377,15300
15,17/11/2011,13.5 (-3.57 %),112,168400,1504,86,210400,2447,-42000
16,16/11/2011,14.1 (0.71 %),151,241100,1597,113,199000,1761,42100
17,15/11/2011,13.8 (-1.43 %),128,202600,1583,76,218900,2880,-16300
18,14/11/2011,14 (-4.11 %),116,165000,1422,113,151400,1340,13600
19,11/11/2011,14.4 (-1.37 %),82,103600,1263,106,190500,1797,-86900
20,10/11/2011,14.5 (-4.61 %),127,228500,1799,92,222100,2414,6400
1,09/11/2011,15 (-1.96 %),77,108900,1414,87,177500,2040,-68600
2,08/11/2011,15.5 (1.31 %),120,288500,2404,101,235300,2330,53200
3,07/11/2011,15.2 (-1.94 %),77,196700,2555,94,235000,2500,-38300
4,04/11/2011,15.4 (-0.65 %),100,183700,1837,107,209700,1960,-26000
5,03/11/2011,15.5 (0.65 %),168,231500,1378,120,167400,1395,64100
6,02/11/2011,15.4 (-3.14 %),175,224800,1285,91,171200,1881,53600
7,01/11/2011,15.8 (-5.95 %),146,305800,2095,236,491100,2081,-185300
8,31/10/2011,16.6 (1.84 %),191,283000,1482,268,544600,2032,-261600
9,28/10/2011,16.5 (6.45 %),214,878500,4105,179,348000,1944,530500
10,27/10/2011,15.6 (1.30 %),98,143500,1464,68,103900,1528,39600
11,26/10/2011,15.4 (0.00 %),96,149200,1554,74,114300,1545,34900
12,25/10/2011,15.3 (-1.92 %),94,172900,1839,110,188500,1714,-15600
13,24/10/2011,15.4 (0.00 %),104,139500,1341,138,195600,1417,-56100
14,21/10/2011,15.6 (3.31 %),157,251700,1603,123,181600,1476,70100
15,20/10/2011,15 (-0.66 %),97,210100,2166,68,124000,1824,86100
16,19/10/2011,15.1 (0.67 %),124,482100,3888,86,155300,1806,326800
17,18/10/2011,15 (-1.96 %),105,162600,1549,118,153100,1297,9500
18,17/10/2011,15.3 (-1.92 %),103,146600,1423,94,126400,1345,20200
19,14/10/2011,15.7 (0.64 %),124,210300,1696,94,216300,2301,-6000
20,13/10/2011,15.5 (0.00 %),164,245300,1496,105,166800,1589,78500
1,12/10/2011,15.6 (-4.88 %),301,484600,1610,167,477400,2859,7200
2,11/10/2011,16.3 (0.62 %),118,538900,4567,120,240100,2001,298800
3,10/10/2011,16.2 (-1.82 %),161,345900,2148,121,258600,2137,87300
4,07/10/2011,16.3 (-2.98 %),162,228800,1412,198,349700,1766,-120900
5,06/10/2011,16.8 (2.44 %),167,453300,2714,182,325400,1788,127900
6,05/10/2011,16.3 (0.62 %),177,477400,2697,152,349400,2299,128000
7,04/10/2011,16.4 (1.23 %),237,796300,3360,182,287100,1577,509200
8,03/10/2011,16.1 (-4.73 %),273,869400,3185,216,484100,2241,385300
9,30/09/2011,16.7 (-4.57 %),199,610300,3067,116,204600,1764,405700
10,29/09/2011,17.4 (-6.95 %),282,735300,2607,368,952400,2588,-217100
11,28/09/2011,18.3 (-4.19 %),147,263400,1792,321,555600,1731,-292200
12,27/09/2011,19.1 (6.11 %),699,1655100,2368,500,1611900,3224,43200
13,26/09/2011,18 (6.51 %),252,934800,3710,47,61200,1302,873600
14,23/09/2011,17.7 (6.63 %),684,2057900,3009,404,1198900,2968,859000
15,22/09/2011,16.6 (0.61 %),111,370900,3341,151,248300,1644,122600
16,21/09/2011,16.5 (-0.60 %),107,271300,2536,174,249200,1432,22100
17,20/09/2011,16.4 (-0.61 %),124,236000,1903,165,316900,1921,-80900
18,19/09/2011,16.5 (1.23 %),159,454700,2860,196,306900,1566,147800
19,16/09/2011,16.1 (-1.23 %),176,371800,2113,222,382500,1723,-10700
20,15/09/2011,16.4 (-2.96 %),229,436500,1906,200,444200,2221,-7700
1,14/09/2011,16.5 (-5.17 %),247,374600,1517,278,586500,2110,-211900
2,13/09/2011,17.3 (4.22 %),235,483400,2057,241,500700,2078,-17300
3,12/09/2011,17.7 (4.12 %),282,594500,2108,248,564200,2275,30300
4,09/09/2011,17.1 (-0.58 %),289,470900,1629,275,520800,1894,-49900
5,08/09/2011,16.9 (3.05 %),198,385600,1947,260,429500,1652,-43900
6,07/09/2011,16.5 (6.45 %),256,471600,1842,146,291100,1994,180500
7,06/09/2011,15.4 (-4.94 %),203,369000,1818,197,377600,1917,-8600
8,05/09/2011,16 (-3.61 %),209,392800,1879,184,398800,2167,-6000
9,01/09/2011,16.7 (2.45 %),221,402900,1823,234,356400,1523,46500
10,31/08/2011,16.2 (-2.41 %),297,363300,1223,283,486600,1719,-123300
11,30/08/2011,16.5 (5.10 %),255,677300,2656,240,611100,2546,66200
12,29/08/2011,15.9 (6.71 %),212,632700,2984,249,449200,1804,183500
13,26/08/2011,14.9 (0.00 %),182,317800,1746,152,385300,2535,-67500
14,25/08/2011,15 (0.00 %),243,498800,2053,179,452800,2530,46000
15,24/08/2011,14.8 (-3.27 %),207,295300,1427,177,425900,2406,-130600
16,23/08/2011,15.1 (-2.58 %),173,318300,1840,167,294300,1762,24000
17,22/08/2011,15.6 (6.85 %),284,831000,2926,178,530400,2980,300600
18,19/08/2011,14.4 (-4.00 %),141,201300,1428,193,295200,1530,-93900
19,18/08/2011,14.6 (0.69 %),237,344500,1454,197,456400,2317,-111900
20,17/08/2011,14.7 (6.52 %),166,365400,2201,193,261300,1354,104100
1,16/08/2011,13.8 (1.47 %),110,158300,1439,96,85700,893,72600
2,15/08/2011,13.7 (-1.44 %),106,121800,1149,69,69700,1010,52100
3,12/08/2011,13.9 (2.96 %),102,87500,858,98,85500,872,2000
4,11/08/2011,13.7 (-1.44 %),138,178100,1291,87,102900,1183,75200
5,10/08/2011,13.9 (4.51 %),153,192300,1257,111,88000,793,104300
6,09/08/2011,13.3 (-5.67 %),197,210200,1067,98,208500,2128,1700
7,08/08/2011,14 (-6.04 %),157,201700,1285,106,192100,1812,9600
8,05/08/2011,14.7 (2.80 %),172,254300,1478,234,389600,1665,-135300
9,04/08/2011,14.5 (6.62 %),112,149800,1338,73,61700,845,88100
10,03/08/2011,13.9 (2.21 %),128,204000,1594,53,53600,1011,150400
11,02/08/2011,13.5 (-2.88 %),100,173500,1735,89,121900,1370,51600
12,01/08/2011,13.9 (-1.42 %),96,205500,2141,69,147200,2133,58300
13,29/07/2011,14 (-2.10 %),111,162800,1467,68,116900,1719,45900
14,28/07/2011,14 (-2.10 %),145,179700,1239,71,162700,2292,17000
15,27/07/2011,14.4 (-2.70 %),147,146000,993,65,102400,1575,43600
16,26/07/2011,14.7 (-2.00 %),105,105700,1007,46,112000,2435,-6300
17,25/07/2011,15.1 (-1.95 %),68,66300,975,50,58000,1160,8300
18,22/07/2011,15.4 (-1.28 %),111,105800,953,61,87500,1434,18300
19,21/07/2011,15.5 (-1.27 %),76,71000,934,85,62700,738,8300
20,20/07/2011,15.8 (1.28 %),126,258400,2051,100,142100,1421,116300
1,19/07/2011,15.6 (-1.89 %),125,140800,1126,73,105800,1449,35000
2,18/07/2011,15.9 (-1.24 %),64,83900,1311,60,82200,1370,1700
3,15/07/2011,16 (-0.62 %),93,138500,1489,66,60700,920,77800
4,14/07/2011,16.2 (0.62 %),110,143400,1304,79,92800,1175,50600
5,13/07/2011,16.1 (0.63 %),121,189800,1569,107,161400,1508,28400
6,12/07/2011,16.6 (0.00 %),201,312400,1554,103,200300,1945,112100
7,11/07/2011,16.5 (-4.62 %),97,112000,1155,72,131900,1832,-19900
8,08/07/2011,17.1 (-1.72 %),98,124600,1271,80,147800,1848,-23200
9,07/07/2011,17.3 (-1.70 %),87,111400,1280,82,71200,868,40200
10,06/07/2011,17.3 (-1.70 %),79,165100,2090,111,136400,1229,28700
11,05/07/2011,17.6 (6.67 %),139,212100,1526,71,131300,1849,80800
12,04/07/2011,16.7 (1.21 %),113,160500,1420,66,76200,1155,84300
13,01/07/2011,16.5 (-4.07 %),160,159800,999,89,111200,1249,48600
14,30/06/2011,17.2 (-2.27 %),156,178800,1146,81,166500,2056,12300
15,29/06/2011,17.8 (-2.20 %),153,154100,1007,96,151700,1580,2400
16,28/06/2011,18.2 (-3.19 %),130,156400,1203,114,222600,1953,-66200
17,27/06/2011,18.7 (0.00 %),99,145100,1466,103,171400,1664,-26300
18,24/06/2011,18.6 (-0.53 %),127,120300,947,107,174600,1632,-54300
19,23/06/2011,18.6 (-4.12 %),105,130300,1241,177,219000,1237,-88700
20,22/06/2011,19.2 (4.92 %),185,316700,1712,233,357600,1535,-40900
1,21/06/2011,18.4 (1.66 %),130,117700,905,120,134300,1119,-16600
2,20/06/2011,18.2 (0.00 %),146,248000,1699,197,318300,1616,-70300
3,17/06/2011,18 (-4.76 %),229,362200,1582,204,346500,1699,15700
4,16/06/2011,19 (1.06 %),217,649600,2994,289,520300,1800,129300
5,15/06/2011,18.7 (-6.97 %),146,304500,2086,233,471400,2023,-166900
6,14/06/2011,19 (-5.00 %),207,477700,2308,299,610600,2042,-132900
7,13/06/2011,20.3 (3.05 %),216,436400,2020,229,386400,1687,50000
8,10/06/2011,19.7 (6.49 %),260,876400,3371,212,600400,2832,276000
9,09/06/2011,18.8 (3.30 %),238,402700,1692,269,432100,1606,-29400
10,08/06/2011,18 (-2.17 %),255,452900,1776,293,570100,1946,-117200
11,07/06/2011,18.5 (6.94 %),202,406100,2010,144,293700,2040,112400
12,06/06/2011,17.5 (1.16 %),252,351000,1393,279,410900,1473,-59900
13,03/06/2011,17.4 (6.75 %),307,902200,2939,400,881900,2205,20300
14,02/06/2011,16.3 (6.54 %),115,278200,2419,78,96300,1235,181900
15,01/06/2011,15.5 (6.90 %),264,430300,1630,146,191100,1309,239200
16,31/05/2011,14.7 (-0.68 %),158,377000,2386,229,295600,1291,81400
17,30/05/2011,14.5 (-0.68 %),218,372100,1707,288,414600,1440,-42500
18,27/05/2011,14.6 (6.57 %),231,375600,1626,104,211100,2030,164500
19,26/05/2011,14.1 (4.44 %),352,628800,1786,304,508000,1671,120800
20,25/05/2011,13.5 (-6.90 %),136,205400,1510,148,339800,2296,-134400
1,24/05/2011,14.5 (-6.45 %),167,211700,1268,176,315500,1793,-103800
2,23/05/2011,15.6 (-5.45 %),186,274000,1473,178,309700,1740,-35700
3,20/05/2011,16.6 (-4.60 %),206,242300,1176,172,266000,1547,-23700
4,19/05/2011,17.2 (-2.82 %),182,217800,1197,147,217900,1482,-100
5,18/05/2011,17.8 (-5.32 %),233,368600,1582,256,369200,1442,-600
6,17/05/2011,18.7 (-6.03 %),289,409200,1416,238,472100,1984,-62900
7,16/05/2011,19.7 (-2.48 %),263,319300,1214,205,337700,1647,-18400
8,13/05/2011,20.2 (-0.98 %),231,304400,1318,162,248700,1535,55700
9,12/05/2011,20.4 (-0.97 %),154,205500,1334,119,129000,1084,76500
10,11/05/2011,20.6 (-1.90 %),171,177000,1035,130,166900,1284,10100
11,10/05/2011,21 (2.94 %),226,411100,1819,263,348700,1326,62400
12,09/05/2011,20.8 (-0.48 %),500,749200,1498,247,617100,2498,132100
13,06/05/2011,21.1 (-0.47 %),230,315100,1370,113,189200,1674,125900
14,05/05/2011,21 (-3.67 %),212,284900,1344,137,244000,1781,40900
15,04/05/2011,21.7 (-1.81 %),139,163400,1176,128,201800,1577,-38400
16,29/04/2011,22.2 (0.45 %),142,128300,904,135,107000,793,21300
17,28/04/2011,21.9 (0.46 %),156,253400,1624,192,197000,1026,56400
18,27/04/2011,22 (0.00 %),199,255400,1283,167,188000,1126,67400
19,26/04/2011,21.8 (-3.11 %),130,100500,773,150,147700,985,-47200
20,25/04/2011,22.1 (0.00 %),331,451100,1363,207,423600,2046,27500
1,22/04/2011,22.3 (-3.46 %),241,359400,1491,171,264300,1546,95100
2,21/04/2011,22.9 (-0.87 %),140,181900,1299,164,191500,1168,-9600
3,20/04/2011,22.9 (-1.29 %),119,125100,1051,100,118700,1187,6400
4,19/04/2011,23.2 (-0.85 %),153,182800,1195,120,199100,1659,-16300
5,18/04/2011,23.1 (-4.94 %),198,237700,1201,161,292600,1817,-54900
6,15/04/2011,24.1 (-2.43 %),168,208100,1239,139,224900,1618,-16800
7,14/04/2011,24.5 (-1.61 %),144,167800,1165,121,165700,1369,2100
8,13/04/2011,24.8 (-1.59 %),129,117900,914,127,159900,1259,-42000
9,08/04/2011,25.1 (-1.57 %),186,256500,1379,164,245500,1497,11000
10,07/04/2011,25.4 (-0.78 %),115,205300,1785,222,355400,1601,-150100
11,06/04/2011,25.8 (2.38 %),143,226300,1583,231,251000,1087,-24700
12,05/04/2011,25.5 (2.82 %),234,382000,1632,221,330000,1493,52000
13,04/04/2011,24.7 (-2.37 %),241,260900,1083,150,257400,1716,3500
14,01/04/2011,25.4 (1.20 %),217,347300,1600,152,231700,1524,115600
15,31/03/2011,25.1 (0.80 %),264,288800,1094,160,322200,2014,-33400
16,30/03/2011,25 (-2.72 %),377,475200,1260,195,313100,1606,162100
17,29/03/2011,25.6 (-2.66 %),282,296100,1050,187,287600,1538,8500
18,28/03/2011,26.4 (0.38 %),138,135900,985,140,204700,1462,-68800
19,25/03/2011,26.2 (-1.87 %),190,168200,885,144,176800,1228,-8600
20,24/03/2011,26.8 (1.52 %),223,275800,1237,254,338900,1334,-63100
1,23/03/2011,26.8 (1.13 %),274,320100,1168,178,227000,1275,93100
2,22/03/2011,26.1 (-5.43 %),311,363800,1170,263,381200,1449,-17400
3,21/03/2011,27.2 (1.12 %),229,355300,1552,339,490700,1447,-135400
4,18/03/2011,27.4 (3.40 %),316,466000,1475,312,439600,1409,26400
5,17/03/2011,26.6 (-0.37 %),317,393500,1241,252,400600,1590,-7100
6,16/03/2011,26.9 (2.67 %),293,333600,1139,297,336800,1134,-3200
7,15/03/2011,26.1 (-2.25 %),260,521300,2005,278,502600,1808,18700
8,14/03/2011,26.2 (-6.76 %),397,566300,1426,423,746200,1764,-179900
9,11/03/2011,28.2 (6.82 %),427,775300,1816,274,704800,2572,70500
10,10/03/2011,26.6 (6.83 %),365,817200,2239,319,382700,1200,434500
11,09/03/2011,24.8 (-4.25 %),366,426500,1165,367,426300,1162,200
12,08/03/2011,25.9 (6.58 %),351,543400,1548,281,413900,1473,129500
13,07/03/2011,24.8 (5.98 %),346,536900,1552,211,347100,1645,189800
14,04/03/2011,24 (-1.64 %),456,626700,1374,278,621200,2235,5500
15,03/03/2011,24.3 (-6.90 %),506,840200,1660,181,939000,5188,-98800
16,02/03/2011,25.9 (-6.83 %),271,251000,926,147,430200,2927,-179200
17,01/03/2011,27.6 (-2.82 %),146,134800,923,122,113300,929,21500
18,28/02/2011,28.2 (-0.70 %),132,158000,1197,143,161300,1128,-3300
19,25/02/2011,28.9 (3.21 %),191,202200,1059,141,128800,913,73400
20,24/02/2011,28.3 (-4.07 %),303,359800,1187,238,319600,1343,40200
1,23/02/2011,29.6 (0.68 %),303,511300,1687,189,289400,1531,221900
2,22/02/2011,29.3 (-6.69 %),208,273900,1317,181,373200,2062,-99300
3,21/02/2011,31.3 (-6.85 %),151,221600,1468,200,408000,2040,-186400
4,18/02/2011,33.4 (-1.76 %),201,258100,1284,181,317000,1751,-58900
5,17/02/2011,33.8 (-1.74 %),222,402700,1814,196,290400,1482,112300
6,16/02/2011,34.1 (-0.87 %),126,238100,1890,213,270800,1271,-32700
7,15/02/2011,34.5 (-0.29 %),148,411200,2778,244,368300,1509,42900
8,14/02/2011,34.3 (-0.29 %),178,596100,3349,220,346100,1573,250000
9,11/02/2011,34.7 (2.06 %),196,706300,3604,212,348000,1642,358300
10,10/02/2011,34 (-0.58 %),214,743800,3476,158,208400,1319,535400
11,09/02/2011,34 (-0.87 %),208,234300,1126,188,267900,1425,-33600
12,08/02/2011,34.3 (-1.72 %),126,181200,1438,113,180300,1596,900
13,28/01/2011,35 (2.94 %),131,223100,1703,261,339000,1299,-115900
14,27/01/2011,34.5 (1.77 %),184,257200,1398,120,157700,1314,99500
15,26/01/2011,34 (1.80 %),197,368900,1873,134,134400,1003,234500
16,25/01/2011,33.1 (-5.16 %),358,500000,1397,221,378000,1710,122000
17,24/01/2011,34.7 (-6.97 %),342,478900,1400,266,739000,2778,-260100
18,21/01/2011,36.7 (-3.42 %),212,483500,2281,374,437700,1170,45800
19,20/01/2011,37.9 (1.34 %),229,397400,1735,393,480600,1223,-83200
20,19/01/2011,37.9 (2.99 %),335,856800,2558,466,656800,1409,200000
1,18/01/2011,36 (3.45 %),527,1394100,2645,772,1137400,1473,256700
2,17/01/2011,34.8 (0.87 %),128,316500,2473,302,397800,1317,-81300
3,14/01/2011,34.6 (-1.14 %),210,348800,1661,327,429500,1313,-80700
4,13/01/2011,34.8 (-1.14 %),151,259200,1717,331,416700,1259,-157500
5,12/01/2011,35 (4.79 %),294,663600,2257,562,756200,1346,-92600
6,11/01/2011,33.8 (-1.17 %),174,570000,3276,298,426000,1430,144000
7,10/01/2011,33.9 (2.42 %),340,864300,2542,640,865700,1353,-1400
8,07/01/2011,33.3 (1.22 %),111,185800,1674,241,209500,869,-23700
9,06/01/2011,33 (0.00 %),133,142400,1071,144,129600,900,12800
10,05/01/2011,32.9 (-2.08 %),131,124100,947,164,160200,977,-36100
11,04/01/2011,33.5 (1.21 %),106,232600,2194,180,178500,992,54100
12,31/12/2010,33.3 (0.00 %),198,360200,1819,188,221500,1178,138700
13,30/12/2010,33.3 (-2.35 %),207,239100,1155,200,259500,1298,-20400
14,29/12/2010,33.9 (-1.45 %),144,370600,2574,347,350900,1011,19700
15,28/12/2010,34.6 (2.98 %),154,263000,1708,328,279200,851,-16200
16,27/12/2010,33.5 (0.90 %),125,120400,963,210,192200,915,-71800
17,24/12/2010,33.4 (3.73 %),297,804900,2710,434,492100,1134,312800
18,23/12/2010,32 (-4.19 %),303,312200,1030,265,300500,1134,11700
19,22/12/2010,33.1 (-2.93 %),296,297000,1003,272,436700,1606,-139700
20,21/12/2010,34 (-1.73 %),194,252200,1300,269,339800,1263,-87600
1,20/12/2010,34 (-1.16 %),206,309500,1502,343,491500,1433,-182000
2,17/12/2010,35 (6.06 %),342,451300,1320,325,344800,1061,106500
3,16/12/2010,32.8 (-6.02 %),406,415000,1022,318,425900,1339,-10900
4,15/12/2010,34.3 (-2.28 %),401,490100,1222,424,527700,1245,-37600
5,14/12/2010,34.8 (-6.45 %),567,622000,1097,716,1014800,1417,-392800
6,13/12/2010,37.3 (6.88 %),436,884500,2029,429,737200,1718,147300
7,10/12/2010,35.3 (6.97 %),327,586500,1794,383,335200,875,251300
8,09/12/2010,33.6 (0.90 %),611,988600,1618,563,806100,1432,182500
9,08/12/2010,32.9 (-6.80 %),430,516400,1201,446,877600,1968,-361200
10,07/12/2010,34.8 (-6.95 %),505,580900,1150,680,925200,1361,-344300
11,06/12/2010,36.5 (-1.88 %),554,614400,1109,631,782700,1240,-168300
12,03/12/2010,37.4 (6.86 %),543,741700,1366,391,554300,1418,187400
13,02/12/2010,35.7 (6.89 %),640,1082500,1691,687,789200,1149,293300
14,01/12/2010,33.1 (-6.50 %),624,832200,1334,686,1093200,1594,-261000
15,30/11/2010,34.7 (0.58 %),742,938100,1264,664,1013200,1526,-75100
16,29/11/2010,35.9 (4.97 %),697,936600,1344,735,864300,1176,72300
17,26/11/2010,34.5 (6.48 %),1006,1347200,1339,638,1151000,1804,196200
18,25/11/2010,32.6 (6.89 %),393,673200,1713,276,290200,1051,383000
19,24/11/2010,30.7 (6.97 %),798,1175800,1473,565,812400,1438,363400
20,23/11/2010,29.1 (6.99 %),427,650600,1524,302,310300,1027,340300
1,22/11/2010,27.8 (1.46 %),476,876500,1841,734,797800,1087,78700
2,19/11/2010,27 (4.65 %),802,1284700,1602,900,1153400,1282,131300
3,18/11/2010,26 (7.00 %),263,470700,1790,171,174700,1022,296000
4,17/11/2010,24.6 (3.36 %),372,486700,1308,308,394800,1282,91900
5,16/11/2010,23.9 (-4.78 %),288,377000,1309,287,355100,1237,21900
6,15/11/2010,24.7 (-5.36 %),268,285700,1066,250,271700,1087,14000
7,12/11/2010,26.1 (-5.78 %),420,455400,1084,359,451900,1259,3500
8,11/11/2010,27.4 (-3.86 %),363,482700,1330,318,487600,1533,-4900
9,10/11/2010,28.6 (0.35 %),301,327700,1089,241,239300,993,88400
10,09/11/2010,28.3 (-6.29 %),526,593600,1129,354,569800,1610,23800
11,08/11/2010,29.7 (-4.19 %),309,287400,930,374,363100,971,-75700
12,05/11/2010,31 (4.03 %),320,369100,1153,392,404300,1031,-35200
13,04/11/2010,30 (2.39 %),307,286000,932,305,227700,747,58300
14,03/11/2010,29.2 (-4.26 %),434,575100,1325,316,400700,1268,174400
15,02/11/2010,30.1 (-5.05 %),353,344800,977,254,307200,1209,37600
16,01/11/2010,31.4 (-2.48 %),274,381200,1391,344,362400,1053,18800
17,29/10/2010,32.2 (-1.23 %),426,593400,1393,505,484200,959,109200
18,28/10/2010,31.9 (-4.78 %),498,634000,1273,794,763400,961,-129400
19,27/10/2010,33.5 (6.69 %),313,373800,1194,213,188300,884,185500
20,26/10/2010,31.4 (6.80 %),491,608800,1240,303,400500,1322,208300
1,25/10/2010,30.1 (-0.66 %),507,704200,1389,548,537700,981,166500
2,22/10/2010,30.3 (-4.72 %),622,712900,1146,571,724000,1268,-11100
3,21/10/2010,31.5 (-5.97 %),869,891800,1026,778,1004600,1291,-112800
4,20/10/2010,33.5 (-6.94 %),130,99600,766,265,443300,1673,-343700
5,19/10/2010,35.8 (-6.77 %),529,489100,925,552,783200,1419,-294100
6,18/10/2010,37.9 (-6.65 %),723,655200,906,621,765300,1232,-110100
7,15/10/2010,40.3 (-4.95 %),653,554600,849,540,603300,1117,-48700
8,14/10/2010,42 (-2.10 %),398,336900,846,463,498400,1076,-161500
9,13/10/2010,42.8 (-1.15 %),311,351600,1131,388,358700,924,-7100
10,12/10/2010,43.4 (2.36 %),819,726500,887,701,647300,923,79200
11,11/10/2010,42.5 (-1.85 %),719,690000,960,646,593100,918,96900
12,08/10/2010,43 (-6.72 %),873,621800,712,588,726200,1235,-104400
13,07/10/2010,45.2 (-4.64 %),618,527800,854,705,614400,871,-86600
14,06/10/2010,47.9 (3.01 %),784,761300,971,769,754300,981,7000
15,05/10/2010,46.6 (-6.61 %),1044,1421200,1361,1107,1699000,1535,-277800
16,04/10/2010,49.9 (-6.90 %),103,78400,761,805,1344700,1670,-1266300
17,01/10/2010,53 (-3.28 %),1093,780100,714,155,621700,4011,158400
18,30/09/2010,54.8 (6.82 %),468,527500,1127,17,114300,6724,413200
19,29/09/2010,52.6 (-4.19 %),1660,1921500,1158,131,1777500,13569,144000
20,28/09/2010,54.9 (-6.95 %),3356,4541300,1353,194,5059300,26079,-518000
1,27/09/2010,59 (-6.94 %),21,7600,362,45,2507100,55713,-2499500
2,24/09/2010,63.4 (-6.90 %),19,28500,1500,60,1966200,32770,-1937700
3,23/09/2010,68.1 (-6.97 %),20,20100,1005,50,1696100,33922,-1676000
4,22/09/2010,73.2 (-6.99 %),65,76200,1172,41,740100,18051,-663900
5,21/09/2010,78.7 (-6.97 %),72,171500,2382,35,330800,9451,-159300
6,20/09/2010,84.4 (-6.95 %),52,73800,1419,20,137400,6870,-63600
7,17/09/2010,90.4 (-1.31 %),144,515500,3580,176,508500,2889,7000
8,16/09/2010,91.4 (0.22 %),157,500200,3186,164,508100,3098,-7900
9,15/09/2010,91.8 (1.44 %),152,526900,3466,225,528800,2350,-1900
10,14/09/2010,91 (0.55 %),184,735800,3999,331,732600,2213,3200
11,13/09/2010,91.7 (1.10 %),137,652400,4762,232,623100,2686,29300
12,10/09/2010,90.3 (-0.22 %),114,431000,3781,221,428200,1938,2800
13,09/09/2010,91 (0.89 %),111,850000,7658,257,849800,3307,200
14,08/09/2010,85 (-4.49 %),277,875800,3162,181,936200,5172,-60400
15,07/09/2010,89 (6.97 %),110,916200,8329,130,858400,6603,57800
16,06/09/2010,83.2 (6.94 %),117,1023100,8744,92,839500,9125,183600
17,01/09/2010,80 (5.96 %),175,881400,5037,121,814600,6732,66800
18,31/08/2010,75.6 (6.78 %),152,720200,4738,81,718800,8874,1400
19,30/08/2010,70.8 (6.95 %),140,648800,4634,55,591900,10762,56900
20,27/08/2010,62.4 (0.16 %),108,654800,6063,96,620500,6464,34300
1,26/08/2010,58.5 (-0.17 %),101,756300,7488,96,718700,7486,37600
2,25/08/2010,55.8 (0.00 %),166,308400,1858,91,367400,4037,-59000
3,24/08/2010,56.8 (6.97 %),110,268300,2439,142,336900,2373,-68600
4,23/08/2010,53.3 (6.81 %),82,471400,5749,98,423300,4319,48100
5,20/08/2010,50.3 (6.79 %),88,522600,5939,151,449300,2975,73300
6,19/08/2010,47.7 (6.95 %),70,315500,4507,119,225100,1892,90400
7,18/08/2010,44.5 (-5.72 %),48,108600,2263,70,146500,2093,-37900
8,17/08/2010,47.2 (1.07 %),37,105100,2841,73,188900,2588,-83800
9,16/08/2010,46.7 (6.86 %),28,45600,1629,15,31200,2080,14400
10,13/08/2010,44.5 (5.45 %),45,103100,2291,25,58600,2344,44500
11,12/08/2010,42 (-3.89 %),60,94300,1572,60,102400,1707,-8100
12,11/08/2010,44.4 (-0.89 %),79,232200,2939,59,198300,3361,33900
13,10/08/2010,45.1 (-5.85 %),61,156700,2569,76,197600,2600,-40900
14,09/08/2010,47 (-4.08 %),62,245300,3956,93,243700,2620,1600
15,06/08/2010,49 (0.00 %),55,187700,3413,82,228700,2789,-41000
16,05/08/2010,48 (-2.44 %),79,200100,2533,94,256000,2723,-55900
17,04/08/2010,50 (1.42 %),94,371500,3952,99,271400,2741,100100
18,03/08/2010,49.2 (0.00 %),93,444900,4784,130,528800,4068,-83900
19,02/08/2010,48.8 (0.00 %),140,727700,5198,111,824600,7429,-96900
20,30/07/2010,50.5 (6.09 %),161,475300,2952,109,401400,3683,73900
1,29/07/2010,49 (6.99 %),136,698700,5138,163,509100,3123,189600
2,28/07/2010,45 (-2.39 %),56,230800,4121,57,182300,3198,48500
3,27/07/2010,46.1 (0.00 %),73,159600,2186,76,173000,2276,-13400
4,26/07/2010,45.1 (-3.01 %),55,164800,2996,73,182700,2503,-17900
5,23/07/2010,46 (0.88 %),54,165000,3056,67,193500,2888,-28500
6,22/07/2010,45.1 (0.00 %),91,167700,1843,77,210300,2731,-42600
7,21/07/2010,45.1 (-0.22 %),55,106400,1935,54,117600,2178,-11200
8,20/07/2010,45.2 (-3.62 %),86,637500,7413,42,371000,8833,266500
9,19/07/2010,46.3 (-0.64 %),106,203700,1922,47,257800,5485,-54100
10,16/07/2010,46.5 (-6.81 %),95,109200,1149,42,193900,4617,-84700
11,15/07/2010,48.7 (-4.51 %),284,850000,2993,69,285800,4142,564200
